/generic_texts/(.... wav)	character	text	
ayuda_familia_maestra	Mujer	¡Tu familia o tu maestra te ayuda a hacer los ejercicios! 	Ayuda
cancion_genioBotella	Oscarcito	La mar estaba serena, serena estaba la mar, La mar estaba serana. Serena estaba la mar. 	
rima_malevo	Mujer	El perro travieso no quiere queso porque le gusta el hueso.	
rima_malevo_oscarcito_1	Oscarcito	travieso	
rima_malevo_oscarcito_2	Oscarcito	queso	
rima_malevo_oscarcito_3	Oscarcito	hueso	
rima_malevo_2	Mujer	El perro huele al pato con su hocico El pato ataca al perro con sus alas y su pico	
rima_malevo_oscarcito_4	Oscarcito	hocico	
rima_malevo_oscarcito_5	Oscarcito	pico	
rima_malevo_3	Mujer	A mi perro Malevo no le gusta el huevo, quiere queso y un hueso y también pide un beso	
rima_malevo_oscarcito_6	Oscarcito	hueso	
rima_malevo_oscarcito_7	Oscarcito	beso	
rima_zorro_gallina	Mujer	Mi amiga la gallina, No vuela, camina. Le encanta comer de todo, Y quedar redonda como un globo.”	
rima_zorro_gallina_oscarcito_1	Oscarcito	gallina	
rima_zorro_gallina_oscarcito_2	Oscarcito	camina	
rima_zorro_gallina_oscarcito_3	Oscarcito	todo	
rima_zorro_gallina_oscarcito_4	Oscarcito	globo	
rima_zorro_gallina_oscarcito_5	Oscarcito	rana	
rima_zorro_gallina_oscarcito_6	Oscarcito	agua	
rima_caperucita	Mujer	Un día Caperucita visitaba a su abuelita el lobo hambriento se adelantó y de la abuela se disfrazó	
rima_caperucita_oscarcito_1	Oscarcito	abuelita	
rima_caperucita_oscarcito_2	Oscarcito	disfrazó	
rima_zapallo_gigante	Mujer	Zapallo, zapallo Para el caballo Maíz, maíz Para la lombriz	
rima_zapallo_gigante_oscarcito_1	Oscarcito	panza	
rima_zapallo_gigante_oscarcito_2	Oscarcito	barata	
rima_zapallo_gigante_oscarcito_3	Oscarcito	caballo	
rima_zapallo_gigante_oscarcito_4	Oscarcito	lombriz	
rima_bichos_bolita	Mujer	Este bicho es un bicho bolita Se enrosca y rueda como una pelotita	
rima_bichos_bolita_oscarcito_1	Oscarcito	bolita	
rima_bichos_bolita_oscarcito_2	Oscarcito	pelotita	
rima_bichos_bolita_2	Mujer	El bicho bolita no nada en el charco como una ranita anda en la tierra enroscado como una pelotita	
rima_bichos_bolita_oscarcito_3	Oscarcito	ranita	
rima_bichos_bolita_3	Mujer	El bicho bolita sueña con poder volar como la mariposa y la abeja, volar y volar pero sólo puede rodar y rodar	
rima_bichos_bolita_oscarcito_4	Oscarcito	volar	
rima_bichos_bolita_oscarcito_5	Oscarcito	rodar	
rima_bichos_bolita_oscarcito_6	Oscarcito	dormir	
rima_bichos_bolita_oscarcito_7	Oscarcito	por ahi	
rima_zorro_hornero_oscarcito_1	Oscarcito	amasa	
rima_zorro_hornero_oscarcito_2	Oscarcito	casa	
rima_zorro_hornero	Mujer	El albañil construye su casa con espátula, cincel y maza. El hornero hace su nido, con ramas, barro y pasto todo unido.	
rima_zorro_hornero_oscarcito_3	Oscarcito	nido	
rima_zorro_hornero_oscarcito_4	Oscarcito	unido	
rima_zorro_hornero_oscarcito_5	Oscarcito	tren	
rima_zorro_hornero_oscarcito_6	Oscarcito	pez	
rima_zorro_hornero_loro_7	Oscarcito	merengue	
rima_zorro_hornero_loro_8	Oscarcito	decente	
rima_risa_pajaros	Mujer	El pajarito en su nidito abre su pico para cantar y mueve sus alas para volar	
rima_risa_pajaros_oscarcito_1	Oscarcito	cantar	
rima_risa_pajaros_oscarcito_2	Oscarcito	volar	
rima_pedro_globo_oscarcito_1	Oscarcito	descansar	
rima_pedro_globo_oscarcito_2	Oscarcito	enredadera	
rima_pedro_globo_oscarcito_3	Oscarcito	veras	
rima_pedro_globo_oscarcito_4	Oscarcito	ya	
rima_pedro_globo_oscarcito_5	Oscarcito	va	
rima_dia_pesca	Mujer	A pescar fue Pablito, no picó un pececito, pero si un viejo zapatito	
rima_dia_pesca_oscarcito_1	Oscarcito	pececito	
rima_dia_pesca_oscarcito_2	Oscarcito	zapatito	
rima_dia_pesca_1	Mujer	Un pececito se fue a nadar y un pescador, con su caña lo quiso pescar pero el pececito no se dejó atrapar	
rima_dia_pesca_oscarcito_3	Oscarcito	pescar	
rima_dia_pesca_oscarcito_4	Oscarcito	atrapar	
rima_dia_pesca_2	Mujer	Cuando el viejo zapato vio a carcajadas el pescador se rió quiso más tarde el pantalón y por muchas medialunas, a Pablito se lo cambió	
rima_dia_pesca_oscarcito_5	Oscarcito	vio	
rima_dia_pesca_oscarcito_6	Oscarcito	rió	
rima_dia_pesca_oscarcito_7	Oscarcito	cambió	
rima_dia_pesca_3	Mujer	Agua ¿adónde vas? Riendo voy por el río a las orillas del mar. Mar, ¿adónde vas? Río arriba voy buscando fuente donde descansar	
rima_dia_pesca_oscarcito_8	Oscarcito	mar	
rima_dia_pesca_oscarcito_9	Oscarcito	descansar	
rima_dia_pesca_oscarcito_10	Oscarcito	cueva	
rima_dia_pesca_oscarcito_11	Oscarcito	levanta	
rima_dia_pesca_oscarcito_12	Oscarcito	chaparrón	
rima_dia_pesca_oscarcito_13	Oscarcito	jabón	
rima_piratas_cantores	Mujer	Los piratas formaron un coro para llenar sus cofres de oro. Recorrieron muchos puertos dando hermosos conciertos	
rima_piratas_cantores_oscarcito_1	Oscarcito	puertos	
rima_piratas_cantores_oscarcito_2	Oscarcito	conciertos	
rima_piratas_cantores_oscarcito_3	Oscarcito	Barbaverde	
rima_piratas_cantores_oscarcito_4	Oscarcito	suegra	
rima_piratas_cantores_oscarcito_5	Oscarcito	negra	
rima_piratas_cantores_oscarcito_6	Oscarcito	verde	
rima_piratas_cantores_oscarcito_7	Oscarcito	muerde	
rima_piratas_cantores_oscarcito_8	Oscarcito	malo	
rima_piratas_cantores_oscarcito_9	Oscarcito	palo	
cancion_piratas_cantores_oscarcito	Oscarcito	Whiski y pis, miti miti, kiwi y vid, distinguis? chin chin 	
rima_baile_oso_1	Mujer	El oso hormiguero camina en busca de su comida con su lengua pegajosa come hormigas deliciosas	
rima_baile_oso_oscarcito_1	Oscarcito	El oso hormiguero camina en busca de su comida con su lengua pegajosa come hormigas deliciosas	
rima_baile_oso_oscarcito_2	Oscarcito	camina	
rima_baile_oso_oscarcito_3	Oscarcito	comida	
rima_baile_oso_oscarcito_4	Oscarcito	pegajosa	
rima_baile_oso_oscarcito_5	Oscarcito	deliciosas	
rima_baile_oso_2	Mujer	Vivía en Chaco un joven muchacho al oso hormiguero salió a cazar pero el oso logró escapar	
rima_baile_oso_oscarcito_6	Mujer	Vivía en Chaco un joven muchacho al oso hormiguero salió a cazar pero el oso logró escapar	
rima_baile_oso_oscarcito_7	Oscarcito	Chaco	
rima_baile_oso_oscarcito_8	Oscarcito	muchacho	
rima_baile_oso_oscarcito_9	Oscarcito	cazar	
rima_baile_oso_oscarcito_10	Oscarcito	escapar	
rima_conejo_1	Mujer	Oscarcito me llamo yo, ooooo, mago mono y conejo tienen como yo, oooo	
rima_conejo_oscarcito_1	Oscarcito	yo	
rima_conejo_oscarcito_2	Oscarcito	oooo	
rima_conejo_oscarcito_3	Oscarcito	conejo	
rima_conejo_oscarcito_4	Oscarcito	estragon	
rima_conejo_oscarcito_5	Oscarcito	dragon	
rima_viaje_espacio_1	Mujer	Viajan las bolitas saltarinas visitando vecinos y vecinas. Ahora son un bello collar que un cuello va a adornar	
rima_viaje_espacio_oscarcito_1	Oscarcito	Viajan las bolitas saltarinas visitando vecinos y vecinas. Ahora son un bello collar que un cuello va a adornar	
rima_viaje_espacio_oscarcito_2	Oscarcito	arrancar	
rima_viaje_espacio_oscarcito_3	Oscarcito	despegar	
rima_viaje_espacio_oscarcito_4	Oscarcito	viajar	
rima_genio_botella	Mujer	La mar estaba serena, serena estaba la mar, La mar estaba sarana. Serena estaba la mar. 	
cancion_genio_botella_oscarcito_1	Oscarcito	La mar astaba saraña, saraña estaba la mar, la mar astaba saraña, saraña astaba la mar.	
cancion_genio_botella_oscarcito_2	Oscarcito	Le mer estebe serene, serene estebe le mer, le mer esteba serene, serene esteba le mer.	
elefante	Mujer	El elefante caminaba adelante	Adivinanzas.
oso	Mujer	Atrás el oso goloso	
serpiente	Mujer	Después la serpiente sin dientes	
serpiente	Mujer	Y al final, el yacaré y su bebé	
unir_estados_elefante	Mujer	¿Cómo estaba el elefante al principio del cuento? ¿Cómo estaba el elefante al final del cuento?	
elefante_aterrorizado	Mujer	Al principio, el elefante estaba...	
elefante_distraido	Mujer	Al final, el elefante estaba...	
caperucita-Recoge	Oscarcito	¿Quién recoge frutos?	
caperucita-Salta	Oscarcito	¿Quién va saltando?	
lobo-corre	Hombre	¿Quien corre?	
lobo-abalanza	Oscarcito	¿Quién se abalanza con la boca abierta?	
asustada	Oscarcito	Al final del cuento ¿como se sentia caperucita roja?	
contento-caperucita	Oscarcito	Al principio del cuento ¿cómo se sentia caperucita roja?	
tallo	Oscarcito	Tallo	
raiz	Oscarcito	Raices	
hoja	Oscarcito	Hoja	
flor	Oscarcito	Flor	
loboSalto	Mujer	El lobo dio un salto	
gallinaCamina	Mujer	La gallina camina	
perroCavo	Mujer	El perro cavó un pozo	
elefante-Camina	Oscarcito	Camina	
serpiente-Desliza	Oscarcito	Se desliza	
oso_cayo	Oscarcito	Se cae	
perro	Oscarcito	Se escapa	
gato-Salta	Oscarcito	Salta	
hornero	Oscarcito	Construye su casa con barro	
hornero-volo	Oscarcito	Voló a un árbol	
pajaros	Oscarcito	Revoloteaban y cantaban	
zorro	Oscarcito	Se fue al trote a la cueva	
barrilete	Oscarcito	¿Con qué se enredó la rama?	
pajaroBlanco	Oscarcito	¿Quién ayudó a Pedro a descender?	
gallinaContenta	Oscarcito	La gallina está contenta	
gallinaEnojada	Oscarcito	La gallina está enojada	
contento-nene	Oscarcito	¿Cómo está el nene?	
donBustosRego	Mujer	Don Bustos regó la planta para que crezca	
vecinosCargaron	Mujer	Los vecinos forzudos cargaron el zapallo para llevarlo a la feria	
mamaBustosCocino	Mujer	Mamá Bustos cocinó el zapallo para probarlo	
abeja-Vuela	Hombre	¿Quién vuela?	
lombriz-Arrastra	Hombre	¿Quien se arrastra?	
ciempies-Camina	Hombre	¿Quien camina?	
bicho_bolita-Rueda	Hombre	¿Quien rueda?	
ramoncitoContento	Hombre	Ramoncito está contento	
ramoncitoAsustado	Hombre	Ramoncito está asustado.	
ramoncitoPreocupado	Hombre	Ramoncito está preocupado	
ñandu-Alto	Oscarcito	¿Quien es más alto?	
pajarito-Pequeno	Oscarcito	¿Quien es más pequeño?	
ñandu-Pesado	Oscarcito	¿Quién pesa más?	
pajarito-Vuela	Oscarcito	¿Quien vuela?	
pablitoContento	Oscarcito	Pablito está contento	
PablitoAtento	Oscarcito	Pablito practica con mucha atención	
pablitoTriste	Oscarcito	Pablito está triste	
pablitoEsperanzado	Oscarcito	Pablito no quería dejarse vencer por las dificultades	
oso_hormiguero	Oscarcito	No tiene dientes, larga es su lengua, come hormigas, vive en la selva, quién es?	
montaña	Oscarcito	Puedo ser alta como el cielo y llegar hasta las nubes. Aunque no estoy vestida, por largas faldas estoy cubierta	
rio	Oscarcito	Desde el día en que nací, corro y corro sin cesar. Corro de noche y de día hasta llegar al mar	
pez	Oscarcito	Soy chiquito, puedo nadar, vivo en los ríos y también en el mar	
pez-mojado	Oscarcito	¿Cuál es el animal más mojado que nada en el agua?	
pajaro	Oscarcito	¿Cuál es el animal que vuela alto?	
perro-camina	Oscarcito	¿Cuál es el animal que camina en 4 patas?	
abeja	Oscarcito	¿Cuál es el animal que vuela de flor en flor?	
sombrero_pirata	Oscarcito	Los piratas tienen un sombrero con un dibujo de una calavera	
parche	Oscarcito	Los piratas tienen un parche en un ojo	
barba	Oscarcito	Los piratas tienen una barba larga y tupida	
mapa_tesoro	Oscarcito	Los piratas llevan un mapa del tesoro	
pata_palo	Oscarcito	Los piratas tienen una pata de palo	
garfio	Oscarcito	Los piratas tienen un garfio por mano	
tripulacion	Oscarcito	Hacen las tareas de bordo, como limpiar o cocinar	
barco	Oscarcito	Lleva a los piratas de puerto en puerto a navegando por el mar	
capitan	Oscarcito	Dirigía a los piratas para que aprendieran a cantar muy bien	
piratasAlegres	Oscarcito	Los piratas están alegres	
piratasTristes	Oscarcito	Los piratas están tristes	
piratasPreocupados	Oscarcito	Los piratas están preocupados	
muchachoAsustado	Oscarcito	Se asustó porque sabía que el oso tenía grandes y fuertes garras	
osoAsustado	Oscarcito	Se asustó porque sabía que a los humanos les gusta cazar animales silvestres	
osoDefiende	Oscarcito	se para y abre los brazos para defenderse	
osoEsquiva	Oscarcito	esquiva los golpes del muchacho	
osoHuye	Oscarcito	huye al monte	
conejo1	Oscarcito	Un conejo fue a ver a un mago para pedirle que lo hacerlo crecer y el mago le pidió bigotes de tigre y cola de mono para transformarlo	
conejo2	Oscarcito	El conejo engaño al tigre, le dijo: para que el viento no te lleve volando te voy a atar al tronco de un árbol grande; así le pudo arrancar los seis bigotes	
conejo3	Oscarcito	El conejo engaño al mono, le dijo que había escondido un secreto; cuando el mono se agachó para ver lo que había adentro le cortó la cola	
conejo4	Oscarcito	El mago pensó que si siendo tan chiquito el conejo había hecho ese daño, entonces convenía no hacerlo crecer	
conejo5	Oscarcito	Después que lo tiró por la montaña el conejo quedó con las orejas largas, las patas delanteras cortas, el pelo blanco y los ojos rojos	
conejoAntes	Oscarcito	orejas cortas	
conejoDespues	Oscarcito	pelo blanco	
conejoAntes-2	Oscarcito	pelo negro	
conejoDespues-2	Oscarcito	orejas largas	
barco-andar	Oscarcito	en una cosa que sirve para andar por el mar	
gorro_lana	Oscarcito	en una cosa que sirve para protegerse la cabeza cuando hace frío	
paraguas	Oscarcito	en algo que sirve para protegerse de la lluvia	
estrella	Oscarcito	Siempre quietas siempre inquietas durmiendo de día de noche despierta	
sol	Oscarcito	Doy calorcito Soy muy redondo Salgo tempranito Tarde me escondo	
abulDesenterro	Oscarcito	desenterró una botella de la arena	
abulDeseo	Oscarcito	le sacó el corcho a la botella y le pidió un deseo al genio	
AbulVolo	Oscarcito	despegó y voló en la alfombra	
AbulZambullo	Oscarcito	se zambulló en el mar	
camello	Oscarcito	Es un animal de cuello alargado que por el desierto va siempre jorobado. Quien es?	
tip_escucha	Nasheli	Escuchá atentamente.	
tip_escuchaL2	Nasheli	Escuchá muy bien.	Tips Consignas
tip_repeat_with_card	Mujer	Escuchá estas palabras y decilas vos.	
tip_escucha_toca	Nasheli	Escuchá bien y tocá los dibujos que corresponden.	
tip_conta_cuento	Oscarcito	¿Te gustó el cuento? Ahora, contalo vos.	
tip_conversar	Dany	Conversá con tu familia, tu maestra o tu maestro.	
tip_questions	Oscarcito	A ver… ¿qué te acordás del cuento?	
tip_falling_objects	Nasheli	Encuentra todos los objetos que te pida la consigna.	
tip_unir	Hombre	¿Cuál va con cuál?	
tip_memotestL2	Nasheli	¿Tenés buena memoria? Encontrá los dibujos y los nombres que son iguales.	
tip_simon	Nasheli	¿Jugamos? Escuchá las palabras y tocá los dibujos en el mismo orden,	
tip_rompecabezas	Nasheli	¡Armá el rompecabezas!	
tip_rompecabezasL2	Nasheli	¡Armá el rompecabezas!	
tip_read_automatic	Nasheli	¡Escuchá el cuento y luego conversá con tu familia, tu maestra o tu maestro!	
tip_read_automaticL2	Dany	¡Escuchá el cuento y luego conversá con tu familia, tu maestra o tu maestro!	
tip_paint	Oscarcito	¡A pintar!	
tip_presentar_letra	Nasheli	Aprendamos una nueva letra, escuchá a la Lora Uma atentamente.	
tip_toca_la_imagen	Nasheli	¿Qué dibujo nombra Uma? Tocalo antes de que Uma termine de nombrarlo.	
tip_labyrinth	Hombre	Encontrá el camino correcto.	
tip_completar	Oscarcito	Completá la rima, ¡yo te ayudo!	
tip_completar_solo	Oscarcito	Ahora completá la rima vos.	
tip_completar_cancion	Nasheli	Escuchemos la canción y otra vez decí vos, como Oscarcito, las palabras que faltan.	
cancion_riman	Mujer	¿Te acordás de la canción? ¿Qué palabras riman?	
que_palabras_riman	Oscarcito	Escuchá bien. ¿Qué palabras terminan igual?	
tip_ordenar_cuento	Oscarcito	Uy, el cuento se desordenó. ¿Qué pasó primero? ¿Y después?... ¿Me ayudás a ordenar el cuento?	
toca_empiezan_igual	Mujer	Ahora vos, nombrá estos dibujos como la lora Uma y tocá los que empiezan igual.	
tip_escucha_rima	Dany	¡Escuchá la rima!	
tip_escucha_cancion	Oscarcito	¿Cantamos?	
tip_leer	Nasheli	Leamos juntos. Tocá la palabra que Uma lee.	
tip_letra	Mujer	Escribamos juntos. ¿Qué letra falta?	
tip_diferencias	Nasheli	Mirá estas imágenes del cuento. ¿Cuáles son las diferencias?	
rima_palabras_loro	Mujer	Ahora vos, nombrá uno de los dibujos como la Lora Uma y tu familia o tu maestra tiene que descubrirlo.	
adivinanzas	Nasheli	Juguemos a las adivinanzas	
elegi_parte_cuento	Nasheli	Escuchamos estas partes del cuento, ¿cuál es la imagen que corresponde a cada una de ellas?	
que_susto_1	Mujer	En el cuento un animal asusta a otro animal, ¿te acordás quién asusta a quién?	Material de Actividades Cuento 1
elefante_1	Mujer	Los elefantes son animales mamiferos, ¿sabés qué es un animal mamífero?	
elefante_2	Mujer	Los animales mamiferos llevan el bebé en la panza hasta que nace, igual que nosotros.	
elefante_3	Mujer	Y después lo amamanta, le da la teta, igual que nosotros.	
queSusto2_2	Mujer	¿Por qué el oso se asustó con el elefante?	
queSusto4_3	Mujer	Y la serpiente ¿por qué se asustó con el yacaré?	
queSusto6_4	Mujer	¿Por qué el gato saltó cuando vio al perro?	
queSusto7_5	Mujer	Y los ratoncitos, ¿por qué huyeron cuando llegó el gato?	
oso_1	Mujer	Los osos, igual que los elefantes, son animales mamíferos.	
oso_2	Mujer	¿Te acordás qué es un animal mamífero?	
oso_3	Mujer	Es un animal que lleva su bebé en la panza y después lo amamanta, le da la teta, igual que nosotros.	
animalesPreferidos_1	Mujer	¿Cuál es tu animal preferido? 	
animalesPreferidos_2	Mujer	¿Cómo es? 	
animalesPreferidos_3	Mujer	¿Por qué te gusta?	
yacare1_1	Mujer	Los yacarés no son mamíferos como los osos y los elefantes, son ovíparos.	
yacare2_2	Mujer	Es decir que las mamás ponen huevos para que nazcan sus hijos.	
yacare3_3	Mujer	Tampoco los amamantan, como hacen los mamíferos.	
animalesMiedo_1	Mujer	A los elefantes les dan miedo los ratones.	
animalesMiedo_2	Mujer	¿A vos te da miedo algún animal? ¿Cuál?	
serpiente_1	Mujer	Las serpientes, igual que los yacarés, son ovíparas.	
serpiente_2	Mujer	¿Te acordás qué es un animal ovíparo?	
serpiente_3	Mujer	Es un animal que pone huevos para que nazcan sus hijos.	
serpiente_4	Mujer	¿Conocés otros animales ovíparos?	
preguntasusto_1	Mujer	La serpiente del cuento se asustó cuando vio los dientes del yacaré.	
preguntasusto_2	Mujer	Vos, ¿alguna vez te asustaste? ¿Cómo fue? ¿Dónde estabas?	
preguntasusto_3	Mujer	¿Con quién estabas? ¿Qué pasó al final?	
elefante_intro	Mujer	¿Querés saber más sobre los elefantes?	
oso_intro	Hombre	¿Querés saber más sobre los osos?	
animales_intro	Oscarcito	¡Hablemos sobre animales!	
yacare_intro	Mujer	¿Querés saber más sobre los yacarés?	
uni_animal_que_asusta	Mujer	Uní al animal que asusta con el que fue asustado.	
serpiente_intro	Mujer	¿Querés saber más sobre las serpientes?	
malevo2_1	Hombre	En el cuento al perro Malevo le regalaron un hueso, ¿te acordás qué hizo Malevo con el hueso que le regalaron?	Material de Actividades Cuento 2
malevo2_2	Hombre	¿Dónde lo escondió?	
malevo8_3	Hombre	¿Dónde encontró Malevo su hueso?	
malevo6_3	Hombre	¿Qué le pasó a Malevo cuando buscaba su hueso? 	
malevo2_5	Hombre	¿Cómo se sintió Malevo cuando le regalaron un hueso?	
malevo8_6	Hombre	¿Cómo se sintió Malevo cuando encontró su hueso?	
malevo5_7	Hombre	En el cuento Malevo se encontró con una pata ¿Dónde se encontró Malevo con la pata?	
malevo5_8	Hombre	¿Qué estaba haciendo la pata?	
malevo5_9	Hombre	¿Por qué pensás que la pata empezó a chillar?	
malevo6_10	Hombre	¿Por qué los patos atacaron a Malevo?	
malevo6_11	Hombre	¿Cómo te parece que Malevo se sintió?	
malevo7_12	Hombre	Malevo vio a un chico armando un castillo en el arenero con su hueso, ¿qué pensó Malevo?	
malevo8_13	Hombre	¿Qué hizo el chico cuando vio a Malevo?	
malevo8_14	Hombre	¿Cómo se sintió Malevo?	
malevo1_15	Hombre	Malevo era un perro callejero, que vivía en la calle y era amigo de los chicos. ¿A vos te gustan los perros?	
malevo1_16	Hombre	¿Tenés un perro en tu casa u otro animal como mascota?	
descripcion_malevo	Hombre	¿Cómo es Malevo? Escuchá cómo es cada parte de su cuerpo.	
descripcion_malevo_2	Hombre	Tiene lomo negro con manchas blancas	
descripcion_malevo_3	Hombre	Tiene hocico para oler y buscar comida	
descripcion_malevo_4	Hombre	Tiene cola que mueve contento	
descripcion_malevo_5	Hombre	Tiene patas para correr	
descripcion_malevo_6	Hombre	Tiene orejas alertas	
perros_1	Hombre	¿Tu mamá, tu papá o alguno de tus amigos tienen o tuvieron un perro u otra mascota? Pediles que te cuenten una historia que les haya pasado con sus mascotas.	
unir_malevo_estados	Mujer	¿Cómo está Malevo? ¿Está contento, asustado o hambriento? Uní las caritas que correspondan a Malevo.	
unir_comida_color	Hombre	Malevo tiene hambre. ¿De qué color es la carne que va a comer ahora? ¿Y el hueso que va a enterrar después? ¿Y el charquito de leche que va a lamer?	
rompecabezas_malevo	Hombre	Completá el rompecabezas de Malevo.	
rompecabezas_pata	Hombre	Completá el rompecabezas de la pata.	
ordenar_malevo_1	Hombre	Malevo escondió el hueso en un lugar secreto	
ordenar_malevo_2	Hombre	Malevo cavó un pozo para buscar su hueso	
ordenar_malevo_3	Hombre	Malevo buscó su hueso en un estanque en el que había una pata	
ordenar_malevo_4	Hombre	Malevo se escapó de los patos	
ordenar_malevo_5	Hombre	Malevo encontró su hueso	
rompecabezas_chico	Hombre	Uno de los chicos de la plaza le quiere hacer un regalo secreto a Malevo. Armá el rompecabezas para ayudar a Oscarcito a descubrir qué es.	
laberinto_malevo	Hombre	Vamos a ayudar a Malevo a encontrar su hueso sin encontrarse con los patos.	
zorroGallina2_1	Mujer	En el cuento, el zorro quiere atrapar a la gallina, ¿por qué?	Material de Actividades Cuento 3
zorroGallina8_2	Mujer	¿Logró el zorro atrapar a la gallina?	
gallina_1	Mujer	Las gallinas son aves, como los pájaros o patos, pero no pueden volar.	
gallina_2	Mujer	Nacen de huevos, por eso son ovíparas.	
zorroGallina4_3	Mujer	El lobo intentó atrapar dos veces a la gallina: ¿qué hizo la primera vez? ¿qué le pasó? ¿a quién asustó?	
zorroGallina6_4	Mujer	¿Qué hizo la segunda vez? ¿Qué le pasó? ¿A quiénes hizo enojar?	
rana_1	Mujer	Las ranas viven en lugares húmedos o cerca del agua, como charcos, lagunas, ríos, arroyos.	
rana_2	Mujer	Tienen los ojos muy saltones y la lengua larga y pagajosa.	
rana_3	Mujer	Las ranas hacen un chillido suave que se llama croar.	
toca_alimentos	Hombre	Tocá todos los alimentos, nombrá todo lo que tocás.	
tocar_animales_oviparos	Mujer	Tocá todos los animales ovíparos, es decir, los que ponen huevos.	
tocar_animales_mamiferos	Mujer	Tocá todos los animales mamíferos, es decir, los que llevan a su bebé en la panza.	
toca_animales	Mujer	Tocá todos los animales.	
zorroGallina5_5	Mujer	En un momento de su paseo, la gallina se encontró con un cerco. ¿Pudo seguir con su paseo? ¿Cómo?	
zorroGallina6_6	Mujer	¿Qué hizo el zorro al encontrarse con el cerco? ¿Qué le pasó?	
unir_animal_hogar	Mujer	Uní al animal con su hogar.	
zorroGallina6_7	Mujer	En el cuento, las hormigas se sienten enojadas porque el zorro cayó arriba de su hormiguero.	
zorroGallina6_8	Mujer	¿Qué te hace sentir contento o contenta? ¿Por qué?	
zorroGallina6_9	Mujer	¿Qué te hace sentir enojado o enojada? ¿Por qué?	
zorroGallina1_10	Mujer	A la gallina le gustaba salir de paseo.	
zorroGallina1_11	Mujer	¿A dónde te gusta ir a pasear a vos?	
zorroGallina1_12	Mujer	¿Qué es lo que más te gusta de ese lugar?	
toca_animales_voladores	Mujer	Tocá todos los animales que vuelan.	
intro_ranas	Nasheli	En el cuento hay unas ranas en el charco, ¿querés saber más sobre las ranas? 	
toca_animales_caminantes	Mujer	Tocá todos los animales que caminan.	
agua	Mujer	Cucú, cantaba la rana. Cucú, debajo del...	
sombrero	Mujer	Cucú, pasó un caballero. Cucú, de traje y...	
romero	Mujer	Cú, cú, pasó un marinero / Cú, cú, vendiendo...	
unir_personajes_estados	Mujer	¿Quién se siente así? Escuchá las palabras y uní cada una con el personaje que le corresponda.	
llorando	Mujer	Cú, cú, no le quiso dar / Cú, cú y se echó a...	
rompecabezas_zorro_gallina	Mujer	Arrastrá las partes del cuerpo que faltan para completar a la gallina.	
laberinto_granja	Mujer	Ayudá a la gallina a dar su paseo y volver a la granja.	
cuentosHambre1_1	Mujer	En el cuento Caperucita se encuentra con el lobo hambriento. ¿A quién se quiere comer el lobo?	Material de Actividades Cuento 4
cuentosHambre2_2	Mujer	¿Te acordás del cuento del perro Malevo? El perro también estaba hambriento, ¿qué quería comer?	
cuentosHambre3_3	Mujer	En el cuento del zorro y la gallina, el zorro estaba hambriento: ¿a quién se quería comer?	
cuentosHambre4_4	Mujer	¿A vos qué te gusta comer cuando tenés hambre?	
intro_bosques	Mujer	En el cuento Caperucita camina por el bosque. ¿Querés saber más sobre los bosques?	
bosque1_1	Mujer	El bosque es un lugar donde hay muchos árboles. Algunos árboles son muy altos.	
bosque2_2	Mujer	También hay plantas con flores y frutos.	
bosque3_3	Mujer	Entre los árboles del bosque viven muchos animales. Hay lobos, osos y ciervos.	
caperucita1_1	Mujer	En el cuento el lobo pensó un plan para comerse a Caperucita y a su abuela. ¿Qué plan pensó el lobo? ¿Por qué el lobo llegó antes a la casa de la abuelita?	
caperucita2_2	Mujer	¿Qué hizo el lobo cuando llegó a la casa de la abuelita?	
elegir_frase_caperucita	Hombre	¿Qué hacen Caperucita y el lobo en el cuento? Uní la palabra con la imagen que corresponda.	
caperucitaDiferencias_1	Hombre	Caperucita vio rara a su abuelita. ¿Por qué la vio rara?	
caperucitaDiferencias_2	Hombre	¿Cómo es el lobo?	
caperucitaDiferencias_3	Hombre	¿Cómo es la abuelita?	
caperucitaDiferencias_3	Hombre	Al principio del cuento, ¿cómo se sentía Caperucita Roja?	
toca_palabras_ca	Mujer	Tocá todos los dibujos que empiezan como Caperucita.	
asustada	Hombre	Al final del cuento, ¿cómo se sentía Caperucita Roja?	
toca_objetos_bosque	Hombre	Tocá todo lo que está en el bosque	
lobo1_1	Mujer	¿Cómo es el lobo? El lobo tiene orejas: oídos para escuchar sonidos lejanos.	
lobo2_2	Mujer	El lobo tiene ojos: ojos para ver durante el día y la noche	
lobo3_3	Mujer	El lobo tiene hocico: hocico para olfatear y buscar comida	
lobo4_4	Mujer	El lobo tiene dientes: dientes filosos para comer carne	
lobo5_5	Mujer	El lobo tiene lomo: lomo peludo para protegerse del frío	
lobo6_6	Mujer	El lobo tiene patas: patas largas y fuertes para correr rápido	
recetaCaperucita_1	Mujer	Caperucita le llevó una torta a su abuelita. Cuando la vuelva a visitar le va a llevar bombones de dulce de leche. Escuchá la receta.	
recetaCaperucita1_2	Mujer	Ingredientes: galletitas blandas tipo vainilla, dulce de leche.	
recetaCaperucita2_3	Mujer	Para hacer los bombones, primero hay que romper las vainillas en miguitas adentro de un plato hondo.	
recetaCaperucita3_4	Mujer	Después se agrega dulce de leche. Se mezcla el dulce de leche con las miguitas.	
recetaCaperucita4_5	Mujer	Con la mezcla se hacen bolitas. ¡Listo! Podés cubrir las bolitas con cacao en polvo, coco rallado o granas de colores.	
elegi_disfraz_lobo	Hombre	Para engañar a Caperucita, el lobo se disfrazó de la abuelita. ¿Qué ropa se puso?	
toca_lo	Mujer	¡Juguemos con los sonidos! Escuchá las palabras y tocá todos los dibujos que empiezan como lobo.	
unir_palabras_iguales	Hombre	¡Juguemos con los sonidos! ¿Qué palabras empiezan igual? Tocá para escuchar las palabras y uní las que empiezan igual.	
chico_multiple	Hombre	¡Juguemos con los sonidos! ¿Qué palabras empiezan igual?	
laberinto_lobo_2	Mujer	Llevá al lobo a la casa de la abuelita.	
escuchar_completar_caperucita	Hombre	¡Juguemos con los sonidos! Escuchá las palabras y decí otra que empiece igual.	
escuchar_completar_caperucita_oscarcito	Oscarcito	Caperucita, cama, ca....	
caperucita_6	Mujer	¿Cómo es el lobo?	
juego_lobo	Hombre	Ahora que aprendiste la canción podés jugar al juego del lobo. Una persona hace del lobo que se va poniendo la ropa. Los demás le van preguntando “¿Lobo está?”. Cuando el lobo está listo sale a perseguir a los otros jugadores para atraparlos.	
laberinto_lobo	Hombre	¿Dónde está el lobo? El lobo se escondió en el bosque para que el cazador no lo atrape. Ayudá al cazador a encontrar al lobo.	
zapalloGigante1_1	Mujer	En el cuento Don Bustos y su familia vivían en un pueblo, Troncón Robusto.	Material de Actividades Cuento 5
zapalloGigante1_2	Mujer	¿Cómo era el pueblo Troncón Robusto?	
zapalloGigante1_3	Mujer	¿Qué hacían por las tardes los vecinos en sus patios?	
zapalloGigante2_4	Mujer	Un día en el patio de Don Bustos creció un zapallo, pero no era un zapallo como cualquier otro.	
zapalloGigante2_5	Mujer	¿Qué tenía de especial ese zapallo?	
toca_verduras	Mujer	Tocá todas las verduras que veas.	
elegi_partes_plantas	Mujer	¿Cómo son las plantas que crecen en los patios de Troncón Robusto? Escuchá y tocá la parte que corresponda.	
raiz	Mujer	Tocá las raices.	
tallo	Mujer	Tocá el tallo.	
hoja	Mujer	Tocá la hoja.	
flor	Mujer	Tocá la flor.	
canastaOscarcito_1	Mujer	¡Mira la canasta de verduras de Oscarcito! ¿Qué tiene dentro?	
toca_elementos_sopa	Mujer	¿Podés armar una canasta igual? Tocá todos los ingredientes para armar una canasta como la de Oscarcito	
zapalloGigante3_6	Mujer	Cuando el zapallo creció todos en la familia Bustos quisieron usarlo.	
zapalloGigante3_7	Mujer	¿Te acordás qué quería hacer Pedrito Bustos?	
zapalloGigante3_8	Mujer	¿Y Mamá Bustos?	
zapalloGigante3_9	Mujer	¿Y Don Bustos?	
zapalloGigante3_10	Mujer	¿A vos qué te gustaría hacer con un zapallo gigante?	
zapalloGigante6_11	Mujer	¿Cómo hizo Don Bustos para llevar el zapallo a la feria?	
zapalloGigante6_12	Mujer	¿Cómo eran los vecinos que lo ayudaron?	
zapalloGigante4_13	Mujer	¿Qué dijeron los vecinos cuando vieron el zapallo?	
laberinto_feria	Mujer	Don Bustos tiene que llevar el zapallo gigante a la feria pero no sabe qué camino tomar, ayudalo a llegar a la feria.	
toca_verduras_cancion	Mujer	Tocá todas las verduras que nombra la canción.	
rompecabezas_zapallo_gigante	Mujer	Arma a Don Bustos regando su zapallo	
toca_empieza_acelga	Mujer	Tocá todo lo que empieza como acelga.	
zapalloGigante5_14	Mujer	En el cuento, cuando Don Bustos lleva el zapallo a la feria aparece un pícaro, ¿sabés qué es un pícaro?	
zapalloGigante5_15	Mujer	Un pícaro es una persona que engaña a otros.	
zapalloGigante5_16	Mujer	¿Cómo engañó el pícaro a Don Bustos?	
zapalloGigante5_17	Mujer	¿Qué le dijo para poder comer el zapallo?	
zapalloGigante5_18	Mujer	En el cuento de Caperucita el lobo engañó a Caperucita, ¿te acordás cómo la engañó?	
presentacionLoroUrielL1	Mujer	Un amigo de Oscarcito tiene una lora que se llama Uma. Uma habla un poco raro. Escuchala.	
tip_toca_la_imagenL2	Nasheli	¿Qué dibujo nombra Uma? Tocalo antes de que termine de nombrarlo.	
tip_repetir_loro	Nasheli	Hablamos como Uma. Repetí las palabras igual que la lora.	
loroUriel_5	Loro	Hoooooola	
loroUriel_6	Loro	Sssssssssoy Uuuuuma.	
loroUriel_7	Loro	Uuuuuma	
ordenar_zapallo_gigante	Mujer	Ordená el zapallo desde el más chico al más grande.	
toca_a	Mujer	Ahora vos, nombrá estos dibujos como la lora Uma y tocá los que empieza como aaazul	
contar_zapallos	Mujer	En la casa de Oscarcito también hay una planta de zapallo. Ayudalo a Oscarcito a contar cuántos zapallos hay en su planta y completá con el número que corresponda.	
presentacionLetraA_1	Loro	Aaaaaaaaacelga	
consigna_elegi_zapallo	Mujer	¿Qué hicieron Don Bustos, Mamá Bustos y los vecinos con el zapallo?	
presentacionLetraA_2	Loro	Aaaaaaaaa	
toca_palabra_acelga	Mujer	Tocá todo lo que comienza como acelga.	
toca_ajo	Mujer	Tocá todo lo que empieza como ajo.	
simon_zapallo_gigante	Nasheli	Voy a cocinar una sopa de verduras pero no se pueden poner todas las verduras al mismo tiempo. Tocá las verduras en el mismo orden.	
bichoBolita1_1	Hombre	¿Quién era Ramoncito?	Material de Actividades Cuento 6
bichoBolita1_2	Hombre	¿Dónde vivía?	
bichoBolita2_3	Hombre	¿Qué pasó cuando apareció un pájaro?	
bichoBolita3_4	Hombre	¿Por qué se quedó preocupado Ramoncito?	
bichoBolita3_5	Hombre	Para consolar a Ramoncito la mamá le mostró un juego que el papá había enseñado a los hermanos de Ramoncito: ¿Cómo era ese juego?	
bichoBolita4_6	Hombre	¿Para qué puede servirles a los bichos bolita ese juego?	
fraseBichoBolita_1	Hombre	Cada mañana, Ramoncito salía de su casa, que estaba debajo de las piedras, para saludar a los otros bichos y bichitos del jardín.	
fraseBichoBolita_2	Hombre	Aquel día pasó algo extraño. Apenas asomó la cabeza vió algo horrible: ¡un pájaro hambriento buscaba alimento entre las plantas! 	
fraseBichoBolita_3	Hombre	Y como los pájaros comen bichitos, ¡sus amigos estaban en peligro! Las langostas saltaron lejos, las mariposas, vaquitas de San Antonio y abejas volaron alto. 	
fraseBichoBolita_4	Hombre	Ramoncito le contó lo que había visto en el jardín esa mañana. Y después le dijo: "¡Mamá, todos escaparon del pájaro pero nosotros no podemos volar ni correr rápido ni saltar alto! ¿Cómo podemos escapar los bichos bolita de los pájaros hambrientos?	
fraseBichoBolita_5	Hombre	Ramoncito giró la cabeza y no pudo creer lo que sus ojos veían. Don Redondón perseguía a los pequeños bichitos bolita, pero si se acercaban mucho, ellos dejaban de caminar y se convertirían en una perfecta bolita gris que rodaba rapidísimo.	
bichoBolita2_7	Hombre	Cuando aparece el pájaro hambriento, los bichitos que estaban en el jardín se escaparon.	
bichoBolita5_8	Hombre	¿Te acordás cómo se escaparon las mariposas, las vaquitas de san antonio y las abejas?	
bichoBolita6_9	Hombre	El ciempiés ¿cómo se escapó?	
bichoBolita6_10	Hombre	¿Y las lombrices?	
bichoBolita7_11	Hombre	¿Qué hicieron las gatas peludas?	
uni_parte_animal	Hombre	Uní cada parte con el animal que corresponde.	
bichoBolita8_12	Hombre	En el cuento los bichos amigos de Ramoncito lograron escaparse del pájaro hambriento. Pero, igual, Ramoncito se quedó preocupado, ¿por qué?	
bichoBolita8_13	Hombre	Cuando Ramoncito le contó a su mamá que estaba preocupado porque no sabía cómo los bichos bolita podían escaparse frente a un peligro, su papá le mostró un juego que le había enseñado a sus hermanos.	
bichoBolita4_14	Hombre	¿Cómo se sintió Ramoncito cuando vio a qué estaban jugando? ¿Por qué?	
laberinto_bicho_bolita	Mujer	Vamos a ayudar al bicho bolita a escaparse del pájaro.	
bichoBolita1_15	Hombre	En el cuento aparecen muchos bichos, además del bicho bolita, hay abejas, mariposas, una gata peluda, una langosta y un ciempiés.	
bichoBolita1_16	Hombre	¿Qué otros bichos conocés?	
bichoBolita1_17	Hombre	¿Cómo son esos bichos?	
insectoAlimento_1	Hombre	Los bichos bolita comen raíces, hojas, flores y frutos de las plantas.	
insectoAlimento_2	Hombre	Les gustan las plantas húmedas, las que tienen agua.	
insectoAlimento2_3	Hombre	Las abejas también se alimentan de las plantas, de un juguito que hay en las flores que se llama néctar.	
insectoAlimento3_4	Hombre	Los ciempiés, en cambio, no comen plantas, comen otros bichos.	
toca_palabras_o	Mujer	Tocá todo lo que empieza como Oscarcito.	
toca_palabras_a	Mujer	Tocá todo lo que empieza como abeja.	
elegi_bicho_bolita	Hombre	Los bichos que aparecen en el cuento se mueven de distinta manera para escaparse. ¿Cómo se mueve cada uno?	
elegi_estados_bicho_bolita	Hombre	¿Cómo está Ramoncito? ¿Está contento, asustado o preocupado?	
presentacionLetraO_1	Loro	Oooooscarcito	
presentacionLetraO_2	Loro	Ooooooooo	
posiciones_bichos_1	Hombre	Escuchá muy bien dónde están los bichos y prestá mucha atención.	
posiciones_bichos_2	Hombre	Abajo hay 2 bichos bolita	
posiciones_bichos_3	Mujer	Arriba hay 1 bicho bolita enroscado y otro estirado	
posiciones_bichos_4	Hombre	1 mariposa y 1 una gata peluda están apoyadas en la piedra	
posiciones_bichos_5	Hombre	Hay 3 mariposas volando	
posiciones_bichos_6	Hombre	Ahora escuchá estas preguntas y tocá el bicho que corresponde	
bicho_bolita-posicion	Hombre	¿Quién está debajo de la piedra?	
gata_peluda-posicion	Hombre	¿Quién está arriba de la piedra	
mariposa-posicion	Hombre	¿Quién estába volando?	
bichoBolita1_18	Mujer	¿Qué bichos te gustan?	
bichoBolita1_19	Mujer	¿Qué bichos te dan miedo?	
uni_insecto_alimento	Hombre	Uní al bicho bolita, al ciempiés y a la abeja con lo que se alimenta cada uno.	
zorroHornero1_1	Mujer	En este cuento, nuevamente hay un zorro hambriento.	Material de Actividades Cuento 7
zorroHornero1_2	Mujer	¿A quién se quiere comer?	
zorroHornero2_3	Mujer	¿Qué hicieron los otros pájaros para ayudar al hornero?	
zorroHornero3_4	Mujer	¿Cómo se sintió el zorro al escuchar a los otros pájaros?	
zorroHornero4_5	Mujer	¿Qué hizo el hornero para lograr que el zorro lo suelte?	
zorroHornero5_6	Mujer	¿Cómo termina la historia?	
elegi_quien_hace	Mujer	¿Quién hace estas cosas?	
zorroHornero3_7	Mujer	En el cuento, el zorro se va sintiendo cada vez más enojado.	
zorroHornero3_8	Mujer	¿Te acordás por qué se enojó primero?	
zorroHornero6_9	Mujer	Y al final del cuento, ¿por qué pensás que se sentía tan enojado?	
zorroHornero4_10	Mujer	El cuento dice que el hornero “es más vivo que el zorro”.	
zorroHornero4_11	Mujer	¿Por qué el hornero es “vivo”?	
zorroHornero4_12	Mujer	¿Cómo logra engañar al zorro?	
zorroHornero7_13	Mujer	En el cuento “El zapallo gigante” también hay un personaje que logra engañar a otro.	
zorroHornero7_14	Mujer	¿Quién es ese personaje?	
zorroHornero7_15	Mujer	¿Te acordás cómo fue ese engaño?	
uni_opuestos	Mujer	Escuchá la palabra. Uní la palabra con su opuesto	
laberinto_zorro_hornero	Mujer	Llevá al Hornero a la rama con los otros pájaros.	
fiesta1_1	Mujer	Los pajaritos se pusieron muy contentos cuando el hornero se escapó: hicieron una fiesta, revolotearon y cantaron.	
fiesta2_2	Mujer	¿Alguna vez hiciste o participaste de una fiesta? ¿Cómo fue?	
fiesta2_3	Mujer	¿Qué cosas pasaron en esa fiesta?	
toca_e	Mujer	Oscarcito le contó el cuento a su amigo Eduardo, que vino de visita. Tocá todas las palabras que empiezan como Eeeeeeduardo, con “Eeeeee”.	
toca_diferente	Mujer	¡En este grupo de personajes hay uno que no corresponde!	
zorroHornero1_16	Mujer	¿Te acordás qué estaba haciendo el hornerito cuando se encontró con el zorro?	
zorroHornero1_17	Mujer	¿Qué estaba agarrando el hornero para construir su nido?	
zorroHornero1_18	Mujer	¿Quiénes construyen las casas de las personas?	
hornero1_1	Mujer	A los horneros también se los llama “pájaros albañiles” porque son muy hábiles para construir sus nidos.	
hornero2_2	Mujer	Estos pájaros juntan barro, piedritas, ramitas y pasto y los van mezclando hasta lograr una masa resistente.	
hornero3_3	Mujer	Con el pico, le van dando forma circular.	
hornero2_4	Mujer	Por dentro, el nido tiene una pared que separa la entrada del lugar donde la hembra pondrá los huevos y se criarán los pichones.	
hornero1_5	Mujer	Tanto la hembra como el macho trabajan juntos para construir su nido.	
toca_palabra_termina_e	Mujer	Tocá todo lo que termine como nube	
toca_circulos	Mujer	Tocá todos los objetos que sean circulares como el nido de los horneros	
risaPajaros1_1	Mujer	En el cuento las aves organizaron una carrera.	Material de Actividades Cuento 8
risaPajaros4_2	Mujer	¿Quiénes jugaron la carrera?	
risaPajaros6_3	Mujer	¿Quién ganó?	
risaPajaros6_4	Mujer	¿Por qué?	
ñandu_1	Mujer	El ñandú es un ave. Tiene plumas, pico y nace de un huevo, es ovíparo.	
ñandu_2	Mujer	Aunque tiene alas, no puede volar. Tiene patas largas y fuertes para correr.	
ñandu_3	Mujer	Su cuello o cogote es largo; tiene una cabeza pequeña y un pico fuerte.	
risaPajaros3_5	Mujer	Todas las aves sintieron miedo al ver al ñandú.	
risaPajaros3_6	Mujer	¿Por qué sintieron miedo?	
risaPajaros3_7	Mujer	¿A vos, algún animal te da miedo? ¿Cuál?	
risaPajaros3_8	Mujer	¿Por qué?	
uni_pajaro_nido	Mujer	El pajarito y el ñandú empollan huevos en sus nidos. Se sientan sobre los huevos para darles calor hasta que nazcan los pichones. ¿Cuál es el nido del pajarito? ¿Cuál es el nido del ñandú?	
risaPajaros1_9	Mujer	En el cuento, las aves juegan a la carrera.	
risaPajaros1_10	Mujer	¿A vos, a qué te gusta jugar?	
risaPajaros1_11	Mujer	¿Con quiénes jugás? ¿Dónde?	
risaPajaros1_12	Mujer	¿Cómo se juega a tu juego favorito?	
risaPajaros6_13	Mujer	Cuando el ñandú del cuento llegó a la meta, los pajaritos se rieron.	
risaPajaros6_14	Mujer	¿Por qué comenzaron a reírse?	
risaPajaros6_15	Mujer	¿A vos, qué cosas te hacen reír?	
ñandu_intro	Mujer	En el cuento hay un ñandú. ¿Querés conocer más sobre el ñandú?	
rompecabezas_risa_pajaros	Mujer	El ñandú es un ave muy grande. Armá el rompecabezas del ñandú para ver lo grande que es.	
laberinto_ñandu	Mujer	Ayudá al ñandú a llegar a la meta.	
laberinto_pajarito	Mujer	Ayudá al pajarito a ir desde la línea de salida hasta la meta.	
toca_termina_a	Mujer	Tocá todo lo que termina como Ala	
ordenar_risa_pajaros	Mujer	¿Cómo se juega a la carrera? Ordená los pasos para jugar	
ordenar_risa_pajaros_1	Mujer	Los competidores se colocan en la línea de largada	
ordenar_risa_pajaros_2	Mujer	Se da la orden de largada	
ordenar_risa_pajaros_3	Mujer	Los competidores corren	
ordenar_risa_pajaros_4	Mujer	Gana el primero que llega a la meta	
unir_animales_sonido	Mujer	Los pajaritos silban. ¿Qué otros sonidos hacen los animales? Uní cada animal con el sonido que hace.	
pajaro-silba	Mujer	el pájaro silba	
gato-maulla	Mujer	el gato maulla	
perro-ladra	Mujer	el perro ladra	
rana-croa	Mujer	la rana croa	
gallina-cacarea	Mujer	la gallina cacarea	
toca_r	Mujer	Tocá todo lo que empieza como ratón.	
presentacionLetraR_1	Mujer	Rrrrrrrrrrrrrrratón	
presentacionLetraR_2	Mujer	RRRRRRRRRRRRRRRRRR	
memotest-aves	Mujer	¿Qué hacen las aves? Juga al memotest	
aves-volar	Mujer	Volar	
aves-empollar	Mujer	empollar	
aves-correr	Mujer	correr	
aves-picotear	Mujer	picotear	
aves-silbar	Mujer	silbar	
toca_aves	Mujer	Tocá todas las aves.	
pedroGlobo1_1	Mujer	¿Con quién se encontró Pedro en la plaza?	Material de Actividades Cuento 9
pedroGlobo2_2	Mujer	¿Qué hacía el payaso?	
pedroGlobo3_3	Mujer	¿Qué pasó cuando Pedro tomó el globo?	
pedroGlobo4_4	Mujer	¿Cómo hizo Pedro para volver a la plaza?	
pedroGlobo1_5	Mujer	A Pedro le gusta mucho ir a la plaza, ¿a vos te gusta?	
pedroGlobo1_6	Mujer	¿Hay alguna plaza cerca de tu casa?	
pedroGlobo1_7	Mujer	En la plaza de Pedro hay toboganes, hamacas y subibajas. También hay juegos en los patios de los jardines de infantes.	
pedroGlobo1_8	Mujer	¿Hay juegos en las plazas que conocés o en tu jardín de infantes?	
toca_cosas_plaza	Mujer	Tocá todas las cosas que puede haber en una plaza.	
pedroGlobo2_9	Mujer	¿Qué globo tomó Pedro?	
pedroGlobo2_10	Mujer	¿Por qué el payaso le preguntó si se animaba a pasear con el globo?	
pedroGlobo2_11	Mujer	¿Qué tenía de especial ese globo?	
pedroGlobo7_12	Mujer	En el cuento “La risa de los pájaros” cuando apareció el ñandú para jugar la carrera los otros pájaros se asustaron.	
pedroGlobo7_13	Mujer	Pero un pájaro, como Pedro, se animó a competir contra el ñandú.	
pedroGlobo7_14	Mujer	¿Te acordás qué pájaro era?	
pedroGlobo7_15	Mujer	¿Vos te animarías a pasear con un globo que te lleve a volar?	
pedroGlobo7_16	Mujer	¿En qué se parece el globo a un pájaro?	
pedroGlobo7_17	Mujer	¿Por qué el pájaro blanco estaba asombrado?	
toca_cosas_vuelan	Mujer	Tocá todas las cosas que vuelan	
uni_estados_pedro_globo	Mujer	¿Cómo estaban Pedro, el gato y el pájaro blanco?¿Por qué? Uní cada personaje con la carita que corresponda.	
preguntaPoesia_1	Mujer	¿Te gustó la canción? ¿De qué colores se pinta la ciudad en primavera?	
pedro_globo_18	Oscarcito	¿Cuántos globos agarró Pedro?	
laberinto_pedro_globo	Mujer	Ayudá a Pedro a volver a la plaza.	
pedro_globo_19	Uriel	Uuuuuuno	
loroPresentacionL1U_1	Oscarcito	¡Uuuuuno empieza como tu nombre Uma! Y el mío empieza como ocho, escuchá Oooooscarcito, oooooocho.	
rompecabezas_pedro_globo	Mujer	En "El Zapallo Gigante" aprendimos cómo se llaman las partes de una planta, ¿ahora te animás a formar un rompecabezas con las partes de un árbol?	
toca_objetos_cuento	Mujer	Tocá todo lo que fue encontrando Pedro en su viaje	
toca_u	Loro	Tocá todo lo que empiece como uuuvas.	
instruccionesGlobo_1	Mujer	¿Alguna vez inflaste un globo? Escuchá los pasos que se necesitan para inflar un globo y ordenalos.	
instruccionesGlobo_2	Mujer	Estirá el globo para que sea más fácil inflarlo	
instruccionesGlobo_3	Mujer	Poné la boca en el agujero del globo y soplá para que se llene de aire	
instruccionesGlobo_4	Mujer	Cerrá con un nudo el agujero del globo para que no se escape el aire	
instruccionesGlobo_5	Mujer	Atá un hilo al globo para poder llevarlo a pasear	
presentacionLetraU_1	Loro	Uuuuuuuvas	
presentacionLetraU_2	Loro	Uuuuuuuuuu	
uni_arboles_estaciones	Mujer	Uní la estación con la imagen que corresponda	
uni_ropa_clima	Mujer	En cada estación el clima también cambia. Uní la ropa que hay que usar con cada estación	
contar_pedro_globo	Mujer	El cielo se llenó de globos y barriletes. Contá cuántos globos y cuántos barriletes hay y completá con el número que corresponda	
diaPesca1_1	Mujer	En el cuento Pablito y su hermano van de pesca.	Material de Actividades Cuento 10
diaPesca1_2	Mujer	Se habían preparado mucho.	
diaPesca1_3	Mujer	¿Qué había hecho Juan para Pablito y qué le había enseñado?	
dia_pesca_4	Mujer	Cuando llegaron al río, ¿qué pescó Pablito?	
dia_pesca_5	Mujer	¿Qué hizo con las cosas que pescó?	
peces_1	Mujer	En el cuento, Pablito y su hermano sacaron un par de zapatos viejos y los peces siguieron nadando en el río.	
peces_2	Mujer	¿Que partes tienen los peces?	
peces_3	Mujer	Los peces tienen aletas para nadar	
peces_4	Mujer	Los peces tienen cola para guiarse	
peces_5	Mujer	Los peces tienen escamas para protegerse	
diaPesca1_6	Mujer	Antes de ir al río Juan le enseñó a pescar a Pablito y Pablito practicó mucho	
diaPesca1_7	Mujer	¿Cómo practicó Pablito?	
diaPesca2_8	Mujer	Cuando llegaron al río, Juan armó la caña, ¿cómo la armó?	
diaPesca2_9	Mujer	¿Qué hizo Pablito mientras Juan armaba la caña?	
diaPesca3_10	Mujer	¿Alguien de tu familia o algún amigo o amiga sabe pescar? Decile que te cuente cómo lo hace.	
ordenar_dia_pesca	Mujer	Ayudemos a Juan y a Pablito a armar la caña de pescar.	
ordenarPesca_1	Mujer	El carretel es parte de la caña de pescar donde se enrosca el hilo	
ordenarPesca_2	Mujer	El anzuelo es la parte de la caña de pescar en la que quedan enganchados los peces, tiene una boyita que queda flotando cuando ya se tiró el hilo al para pescar	
ordenarPesca_3	Mujer	La carnada se sostiene en el anzuelo, es un pedazo de carne, lombriz u otro bicho para atraer a los peces al anzuelo	
toca_peces	Mujer	Tocá todos los peces.	
diaPesca1_11	Mujer	La primera vez que Pablito tiró la caña al río, le pareció que había picado un pez, ¿cómo se sintió?	
diaPesca4_12	Mujer	Pero Pablito pescó un zapato, ¿cómo se sintió cuando lo vio?	
diaPesca4_13	Mujer	¿Cómo reaccionaron los otros pescadores?	
diaPesca5_14	Mujer	¿Qué hizo Pablito después?	
diaPesca5_15	Mujer	¿Qué pescó en los otros intentos?	
diaPesca5_16	Mujer	¿Por qué los otros pescadores se acercaban cada vez más?	
diaPesca6_17	Mujer	Al final, ¿qué se llevaron Pablito y Juan a su casa?	
diaPesca6_18	Mujer	¿Cómo consiguieron las cosas que se llevaron?	
unir_pez_color	Mujer	Escuchá el color y tocá el pez que corresponda.	
toca_partes_caña	Mujer	¿Cuáles son las partes de una caña de pescar? Tocá según corresponda.	
toca_partes_pez	Mujer	¿Cuáles son las partes del pez? Tocá la imagen según corresponda.	
saco_pablito_rio	Mujer	¿Qué sacó Pablito del río? 	
saco_pablito_rio_completo	Mujer	¿Qué llevó Pablito a su casa?	
elegi_dia_pesca	Mujer	Escuchá cómo está y se siente Pablito en los distintos momentos del cuento y tocá la imagen que corresponda.	
intro_rios	Mujer	En el cuento “Un día de pesca” Pablito y su hermano Juan van a pescar al río, ¿querés aprender sobre los ríos?	
rios1_1	Mujer	Un río es agua que corre por la tierra.	
rios3_2	Mujer	¿Cómo se forman los ríos? El agua de lluvia baja corriendo por las faldas de las montañas y forma arroyos.	
rios4_3	Mujer	Los arroyos se unen formando ríos. Los ríos desembocan en el mar.	
rios2_4	Mujer	En los ríos y los mares viven peces de distintos tipos y colores.	
rios2_5	Mujer	¿Hay algún río cerca de tu casa? ¿Fuiste alguna vez a pasear a un río?	
elegi_animales_dia_pesca	Mujer	Aprendimos mucho de animales. ¿Te animás a responder estas preguntas?	
barquitoPapel_1	Mujer	Cuando llueve y se junta un poco de agua se forman charcos en los caminos y en los campos.	
barquitoPapel_2	Mujer	Los charcos tienen poquita agua, no como los arroyos y los ríos.	
barquitoPapel_3	Mujer	Cuando deja de llover y antes de que se sequen, en los charcos se puede jugar, por ejemplo, se puede hacer navegar barquitos de papel.	
unir_estaciones_ropa	Mujer	Ayudá a Oscarcito a elegir qué usar para protegerse cuando hay mucho sol, cuando hace frío y cuando llueve	
armar_barquito	Mujer	Ahora te toca a vos hacer el barquito	
contar_dia_pesca	Mujer	¿Cuántos charquitos tiene que saltar Oscarcito para llegar a su casa?	
piratasCantores2_1	Mujer	El capitán pirata tenía un canario como mascota.	Material de Actividades Cuento 11
piratasCantores3_2	Mujer	¿Qué clase de canciones sabía el canario?	
piratasCantores9_3	Mujer	¿Qué pasaba cuando el canario cantaba canciones tristes?	
piratasCantores4_4	Mujer	¿Qué pasó con los cofres donde los piratas guardaban sus monedas?	
piratasCantores5_5	Mujer	¿Qué idea se le ocurrió al capitán pirata? ¿Funcionó esa idea?	
piratasCantores7_6	Mujer	¿Cómo ganaron dinero a partir de ese momento?	
elegi_piratas	Hombre	¿Cómo son los piratas y qué cosas tienen?	
toca_nohayen_barco	Hombre	¿Qué cosas no podemos encontrar en un barco pirata? Tocá las cosas que no corresponden.	
toca_i	Hombre	Tocá todo lo que empiece con i.	
memoria_escondida	Mujer	¿Tenés buena memoria? Escuchá la palabra y encontrá dónde está escondida.	
laberinto_piratas	Mujer	Llevá al Capitán Pirata hasta el tesoro.	
piratasCantores2_7	Hombre	¿A qué se dedican los piratas? ¿Cómo consiguen, habitualmente, sus tesoros?	
elegi_acciones_piratas	Hombre	¿Quien hace estas cosas?	
unir_canario_pirata	Hombre	¿Qué empieza como Canario y qué empieza como Pirata?	
piratasCantores4_9	Hombre	En el cuento, los cofres de los piratas se quedaron vacíos.	
piratasCantores4_10	Hombre	¿Por qué se les acabaron las monedas a los piratas del cuento?	
piratasCantores4_11	Hombre	¿Por qué no podían solucionar ese problema echando al canario?	
elegi_emociones_piratas	Hombre	¿Cómo se sienten los piratas?	
toca_vehiculos	Hombre	Los barcos son vehículos que llevan a personas o cargamentos a través del río o del mar. ¿Qué otros vehículos hay? Tocá todos los vehículos.	
unir_vocales	Hombre	Uni las palabras que empiezan con la misma vocal.	
piratasCantores5_12	Hombre	En el cuento, al capitán pirata se le ocurre cantar por el mundo con su coro de piratas para volver a llenar sus cofres.	
piratasCantores6_13	Hombre	¿Qué tuvieron que hacer los piratas para poder cantar por el mundo? ¿Quién los ayudó?	
piratasCantores1_14	Hombre	¿A la gente le gustaba escuchar al coro de piratas?	
piratasCantores1_15	Hombre	¿Qué pasaba cuando se presentaban a cantar en los puertos del mundo?	
intro_coros	Hombre	Los piratas formaron un coro y se presentaron en muchos puertos con su espectáculo de canciones. ¿Querés saber más sobre el coro?	
coros1_1	Mujer	El coro es un grupo de personas que se juntan a cantar.	
coros2_22	Mujer		
coros2_2	Mujer	Las personas tenemos distintos tipos de voces, algunas son más graves, con sonidos como este:	
coros3_33	Mujer		
coros3_3	Mujer	Otras son más agudas, con sonidos como este:	
coros1_4	Mujer	Cuando las distintas voces se juntan en el coro forman hermosas canciones.	
coros4_5	Mujer	El coro tiene un director que ayuda a que las voces suenen bien juntas.	
coros5_6	Mujer	Algunos coros, además, tienen una orquesta.	
contar_piratas_cantores	Hombre	Las monedas de oro se cayeron del cofre pirata. ¿Cuántas contás?	
rompecabezas_piratas_cantores	Hombre	Los Piratas Cantores enterraron el cofre lleno de monedas en una isla pero el mapa que hicieron se les rompió. ¿Podes resolver el rompecabezas para ver el mapa?	
piratasCantores3_16	Hombre	El canario del capitán también sabía cantar canciones alegres. ¿Te acordás qué pasaba cuando las cantaba?	
piratasCantores7_17	Hombre	¿A vos te gusta cantar? ¿Cuál es la canción que más te gusta?	
piratasCantores7_18	Hombre	¿Te animás a cantársela a tu maestra, tus amigos o tu familia?	
oscarcitoDibujo_1	Hombre	Después de escuchar el cuento, Oscarcito se imaginó que los Piratas Cantores enterraban el cofre lleno de monedas en una isla y hacían un mapa para poder volver a buscarlo. Hizo un dibujo, de la isla y el mapa. Ahora quiere escribir la palabra “isla” y la palabra “mapa”. 	
laberinto_pirata	Hombre	Los piratas solían enterrar sus tesoros para que nadie pudiera sacárselos. Y para encontrarlos, hacían mapas para recordar dónde estaban ocultos. Llevá al pirata hasta el tesoro enterrado.	
baileOso1_1	Mujer	Hace mucho tiempo, un muchacho fue al monte a cazar. En el monte crecen muchas plantas y viven muchos animales. ¿Con quién se encontró el muchacho?	Material de Actividades de cuento 12
baileOso2_4	Mujer	¿Por qué se asustó el muchacho?	
baileOso2_5	Mujer	¿Por qué se asustó el oso hormiguero?	
baileOso8_7	Mujer	¿Qué pasó al final?	
elegi_razon_susto	Mujer	¿Por qué se asustó el muchacho cuando vio al oso? ¿Por qué se asustó el oso cuando vio al muchacho?	
intro_oso_hormiguero	Mujer	En el cuento aparece un oso hormiguero. ¿Querés saber más acerca de los osos hormigueros?	
osoHormiguero_1	Mujer	El oso hormiguero es un animal que vive en los montes, bosques y pastizales. Se lo llama oso hormiguero porque se alimenta de hormigas.	
osoHormiguero_2	Mujer	Su pelo es de color gris. 	
osoHormiguero_3	Mujer	Tiene cuatro patas con garras y uñas fuertes que usa para abrir los hormigueros y para defenderse de los animales y cazadores que lo atacan.	
osoHormiguero_4	Mujer	Tiene una cabeza pequeña con un hocico largo y la boca ubicada en la punta. No tiene dientes.	
osoHormiguero_5	Mujer	En cambio, tiene una lengua larga y pegajosa para atrapar las hormigas. Su cola es larga y peluda.	
osoHormiguero_6	Mujer	El pelo le sirve para protegerse de las picaduras de las hormigas.	
baileOso_1	Mujer	¿Qué pasó en esta parte del cuento?	
baileOso_2	Mujer	¿Qué usó el muchacho para amenazar al oso?	
baileOso_3	Mujer	¿Qué hizo el oso para defenderse?	
toca_amenazantes	Mujer	Tocá todos los que son amenazantes	
laberinto_baile_oso	Mujer	¿Dónde están las hormigas? El oso hormiguero tiene hambre. Ayudalo a encontrar las hormigas para comer.	
baileOso7_7	Mujer	¿Qué les contó y les mostró el muchacho a sus amigos al final del cuento?	
baileOso7_8	Mujer	¿Qué empezaron a hacer los amigos?	
baileOso8_9	Mujer	¿Por qué en el Chaco dicen que así nació el baile?	
laberinto_baile_oso_2	Mujer	Ayudá al oso hormiguero a volver a su cueva en el monte.	
rompecabezas_baile_oso	Mujer	Los amigos del muchacho y otras personas del pueblo bailaron imitando al oso y al muchacho. Arma el rompecabezas para verlo!	
baileOso1_8	Mujer	En el cuento, el muchacho se asustó al ver las garras del oso porque pensó que podía hacerle una herida.	
baileOso1_9	Mujer	¿Vos te lastimaste y te hiciste una herida alguna vez?	
baileOso1_10	Mujer	Contale a tu maestra, a tus amigos o a alguien de tu familia cómo te lastimaste.	
baileOso1_11	Mujer	¿Dónde estabas? ¿Con quién? ¿Con qué te lastimaste? ¿Cómo te curaste?	
elegi_acciones_oso	Mujer	¿Qué hace el oso en el cuento?	
rompecabezas_baile_oso_2	Mujer	Armá el rompecabezas del oso hormiguero	
oscarcitoDibujo3_1	Mujer	Oscarcito dibujó al oso hormiguero y escribió oso. También escribió su nombre para que todos supieran que lo había hecho él. Ayudá a Oscarcito a escribir.	
osoHormiguero_10	Mujer	El oso hormiguero es un animal silvestre.	
osoHormiguero_11	Mujer	Los animales silvestres son animales que viven en el campo, en el monte o en la selva.	
osoHormiguero_12	Mujer	Los animales silvestres no viven adentro de una casa.	
oscarcitoDibujo4_1	Mujer	Oscarcito le mostró el dibujo del oso a la lora Uma. La lora leyó "oso". Leé con la lora. Tocá donde dice oso.	
oscarcitoDibujo5_1	Mujer	El loro también leyó “Oscarcito”. Leé con el loro. Tocá donde dice Oscarcito.	
pintar_baile_oso	Mujer	Pintá los animales silvestres.	
conejo1_1	Mujer	La leyenda cuenta que los conejos antes eran muy distintos de cómo son ahora ¿Cómo eran antes los conejos?	Material de Actividades de cuento 13
conejo2_2	Mujer	Los conejos querían ser más grandes, entonces un día un conejo fue a ver a un mago para que lo hiciera crecer ¿qué le pidió el mago que trajera?	
conejo3_3	Mujer	¿Cómo consiguió el conejo lo que el mago le pedía?	
conejo5_4	Mujer	Al final, ¿el mago hizo crecer al conejo?	
conejo6_5	Mujer	¿Cómo quedó el conejo finalmente?	
unir_animales_orejas	Mujer	Todos somos diferentes de las orejas a los pies. Juguemos, ayudá a los animales a encontrar sus orejas.	
conejo2_6	Mujer	El mago le pidió al conejo seis bigotes de tigre y una cola de mono para hacer una pócima que lo hiciera crecer	
conejo3_7	Mujer	¿Te acordás cómo engañó el conejo al tigre para sacarle los tres bigotes?	
conejo4_8	Mujer	¿Te acordás cómo engañó el conejo al mono para sacarle la cola?	
intro_pocion	Mujer	¿Sabés qué es una poción? Si no sabés, te enseño.	
pocion_1	Mujer	En los cuentos los magos, los hechiceros y las brujas usan pociones mágicas para convertir algo en otra cosa, por ejemplo un sapo saltarín en una planta con raíz.	
pocion_2	Mujer	Las pócimas también se pueden usar para cambiar el tamaño o el color de los animales o las cosas.	
pocion_3	Mujer	Para preparar una pócima se necesita un caldero grande que se calienta en el fuego.	
pocion_4	Mujer	En el caldero se mezclan, con un gran cucharón, los ingredientes de la pócima	
pocion_5	Mujer	Por ejemplo, una cola de mono y dos bigotes de tigre o un gusano, dos dientes de ajo y un pedacito de zapallo	
pocion_6	Mujer	Muchas veces para que la pócima tenga efecto, es necesario hacer unos pases de magia con una varita y decir unas palabras mágicas que se llaman conjuro.	
toca_objetos_mago	Mujer	Tocá las cosas que le pueden servir a magos, brujos y hechiceros para preparar sus pociones	
conejo5_9	Mujer	Cuando el conejo le llevó al mago los bigotes de tigre y la cola de mono ¿qué pensó el mago?	
conejo5_10	Mujer	¿Los usó para hacer crecer al conejo?	
conejo5_11	Mujer	¿Por qué el mago actuó de la forma en que lo hizo?	
toca_instrumentos_musicales	Mujer	El corno y el bongo son instrumentos musicales ¿Qué otros instrumentos conocés? Tocá los que son instrumentos musicales	
toca_termina_o	Mujer	Tocá todo lo que termina con o.	
conejo6_12	Mujer	Al final del cuento, ¿cómo quedaron las orejas del conejo, sus patas delanteras y sus ojos? ¿Por qué?	
elegi_conejo	Mujer	¿Cómo era el conejo al principio y al final del cuento?	
conejo6_13	Mujer	¿Conocen otros cuentos en los que haya magos o brujas? ¿Qué era lo que pasaba en ese o esos cuentos?	
elegi_hechizos_mago	Mujer	¿En que convirtió el mago un plato grande y redondo?	
loro_conjuro	Mujer	Bigotes de tigre, cola de mono, que desde hoy para siempre seas un loro. 	
lombriz_conjuro	Mujer	Alas de murciélago y un poco de anís, que desde hoy y para siempre seas una lombriz	
unir_conjuros	Mujer	Completá los conjuros con el nombre que rime	
viajeEspacio1_1	Mujer	¿Dónde vivía Melisa?	Material de Actividades de Cuento 14
viajeEspacio2_2	Mujer	¿A qué jugaban Melisa y su hermano?	
viajeEspacio3_3	Mujer	¿Qué pasó cuando fueron a sacar las bolitas del cráter? ¿Por qué?	
viajeEspacio3_4	Mujer	¿Cómo se dieron cuenta?	
contar_viaje_espacio_1	Mujer	Ayudá a Melisa a contar cuantas bolitas violetas hay	
contar_viaje_espacio_2	Mujer	Ayudá a Melisa a contar cuantas bolitas verdes hay	
contar_viaje_espacio_3	Mujer	Ayudá a Melisa a contar cuantas bolitas amarillas hay	
ordenar_viaje_espacio_1	Mujer	A Oscarcito le dieron ganas de jugar a las bolitas. ¿Lo ayudás? Ordená los pasos para jugar a la bolita.	
ordenar_viaje_espacio_2	Mujer	Se hace un pocito en la tierra.	
ordenar_viaje_espacio_3	Mujer	Se reparten 2 o más bolitas para cada jugador	
ordenar_viaje_espacio_4	Mujer	El primer jugador tira una bolita intentando embocarla en el pocito.	
ordenar_viaje_espacio_5	Mujer	Luego tira su bolita el segundo jugador	
ordenar_viaje_espacio_6	Mujer	Gana el que primero mete todas las bolitas en el pocito.	
presentacionLetraS_1	Mujer	Sssssss	
presentacionLetraS_2	Mujer	¡Saltarina!	
viajeEspacio3_7	Mujer	En el cuento, las bolitas de Melisa y su hermano se cayeron del Planeta Verde porque el cráter donde las embocaban no tenía fondo	
viajeEspacio4_8	Mujer	¿A dónde fue primero Melisa a buscar las bolitas?	
viajeEspacio4_9	Mujer	¿Qué pensó Doña Pepa que eran las bolitas?	
viajeEspacio4_10	Mujer	¿Por qué las bolitas volvieron a caerse al planeta de abajo?	
viajeEspacio5_11	Mujer	¿Qué hizo Melisa?	
rompecabezas_viaje_espacio	Mujer	En el lugar donde vive Melisa los planetas están uno debajo del otro. Armá el rompecabezas para ver cómo están ordenados	
intro_repeat_planetas	Mujer	¿Sabías que en nuestro sistema solar hay 8 planetas y que giran alrededor del sol?	
viajeEspacio5_12	Mujer	Cuando Melisa llegó al Planeta Azul, Doña Pepa ya había mandado las bolitas al planeta de abajo, el Amarilllo.	
viajeEspacio6_13	Mujer	¿Qué pasó cuando las bolitas llegaron al Planeta Amarillo?	
viajeEspacio6_14	Mujer	¿Cómo se sintió Don Pancho cuando las bolitas lo golpearon?	
viajeEspacio6_15	Mujer	¿Qué hizo Don Pancho con las bolitas?	
uni_transporte_medio	Mujer	¿Por dónde viaja cada uno? Llevá el medio de transporte al lugar por donde viaja.	
toca_termina_igual	Mujer	Tocá todo lo que termina igual.	
viajeEspacio7_16	Mujer	Cuando Melisa llegó al Planeta Amarillo, Don Pancho ya había mandado las bolitas al planeta de abajo, el Planeta Violeta.	
viajeEspacio7_17	Mujer	¿Con quién se encontró Melisa en el Planeta Violeta?	
viajeEspacio7_18	Mujer	¿Qué hizo Doña Temis con las bolitas?	
viajeEspacio7_19	Mujer	¿A quién se las envió?	
viajeEspacio8_20	Mujer	¿Qué descubrió Melisa al regresar a su planeta?	
laberinto_viaje_espacio	Mujer	Ayudá a Melisa a regresar a su planeta	
toca_cosas_cielo	Mujer	Oscarcito se puso a mirar el cielo. ¿Qué cosas podemos encontrar en el cielo? Tocá lo que podemos encontrar en el cielo.	
genioBotella3_1	Hombre	¿Quién era Abul? ¿Dónde vivía?	Material de Actividades de Cuento 15
genioBotella1_3	Hombre	¿Qué encontró Abul en la arena? ¿Qué deseo le pidió Abul al genio de la botella?	
genio_botella_4	Hombre	¿Logró cumplir su deseo?	
genioBotella_1	Hombre	¿Qué pasó en esta parte del cuento?	
genioBotella_2	Hombre	¿Qué deseo le pidió Abul al genio de la botella?	
genioBotella_3	Hombre	¿Y a vos, qué deseo te gustaría pedir?	
intro_desierto	Hombre	Abul y su familia vivían en el desierto. ¿Querés conocer más sobre el desierto?	
desierto_1	Mujer	El desierto es un lugar donde hace mucho calor y hay poca agua, llueve muy poco.	
desierto2_2	Mujer	Hay pocos animales y plantas porque no tienen agua para vivir.	
desierto3_3	Mujer	Hay montañas de arena que se llaman dunas	
pintar_genio_botella	Hombre	Pintá todo lo que empieza como mar.	
genio_botella_5	Hombre	Cuando regresaba de viaje el papá de Abul le contaba historias. La historia que más le gustaba a Abul era sobre el mar.	
genio_botella_6	Hombre	¿Cuál es tu historia preferida? ¿De qué se trata?	
genio_botella_7	Hombre	¿Quién te la cuenta?	
toca_cosas_protegerse_sol	Hombre	En el desierto el sol brilla muy fuerte y hace mucho calor. Tocá todo lo que puede usarse para protegerse del sol.	
rompecabezas_genio_botella	Hombre	En el cuento Abul y su papá viajan en camello. Armá el rompecabezas del camello.	
intro_camello	Hombre	¿Querés saber más sobre los camellos?	
camello1_1	Mujer	Los camellos tienen joroba con grasa para mantenerse frescos.	
camello2_2	Mujer	Los camellos tienen orejas pequeñas y peludas para que no les entre arena.	
camello3_3	Mujer	Los camellos tienen ojos con pestañas y cejas peludas para protegerse del sol y de la arena.	
camello4_4	Mujer	Los camellos tienen boca con labios fuertes para comer plantas con espinas.	
camello5_5	Mujer	Los camellos tienen patas largas y fuertes para caminar mucho y llevar cargas pesadas.	
genioBotella2_8	Nasheli	¿Qué hizo Abul cuando llegó a la playa y se acercó al mar? ¿Cómo se sintió?	
genioBotella2_9	Nasheli	¿A vos, qué te hace sentir feliz?	
laberinto_genio_botella	Hombre	Abul tenía muchas ganas de conocer el mar, pero quedaba muy lejos. El genio cumplió el deseo de Abul y lo llevó a conocer el mar. Ayudá a Abul a viajar hasta el mar.	
contar_genio_botella	Hombre	El papá de Abul tiene que entregar un cargamento de alfombras. ¿Cuántas alfombras hay?	
genioBotella3_10	Hombre	A Abul le gustaba jugar a hacer castillos de arena y tirarse por las dunas como si fueran un tobogán.	
genioBotella3_11	Hombre	¿A vos a qué te gusta jugar? ¿Cómo se juega?	
genioBotella3_12	Hombre	¿Con quién jugás? ¿Dónde jugás? 	
elegi_genio_botella	Hombre	¿Qué hizo Abul durante el viaje?	
escuchar_cancion_oscarcito	Hombre	Escuchá cómo canta la canción Oscarcito. Cantala como hace Oscarcito.	
escribir_genio_botella	Hombre	Oscarcito tampoco conoce el mar y quiere mandarle un mensaje al genio de la botella para que le cumpla el deseo. Ayudá a Oscarcito a escribir mar.	
tocar_cosas_vuelan	Hombre	En el cuento Abul y el genio volaron en la alfombra para llegar al mar. Tocá las cosas que pueden volar como la alfombra del genio.	
toca_cosas_desierto	Hombre	Tocá todo lo que podemos encontrar en el desierto.	
tip_ordenar	Hombre	Ordená la secuencia según corresponda	
tip_contar	Mujer	Contá cuántos objetos hay y tocá el número que corresponda.	
toca_empieza_diferente	Mujer	Decí vos como la lora Uma estas palabras. Tocá la que empieza diferente a las demás.	
loroPresentacionL1A_1	Mujer	Aaaaa...	
loroPresentacionL1A_2	Mujer	¡acelga!	
tip_presentar_letraL2	Nasheli	Aprendemos las letras con Uma.	
loroPresentacionL1O_1	Mujer	Oooooo....	
loroPresentacionL1O_2	Mujer	¡Oscarcito!	
loroPresentacionL1U_2	Oscarcito	¿Y tu nombre cómo empieza?	
letraIL2_1	Hombre	Iiiiiiiiiiiiiiii	
letraIL2_2	Hombre	¡Pis!	
completa_cancion	Oscarcito	Completá la canción, yo te ayudo.	
completa_cancion_solo	Oscarcito	Ahora completá la canción vos.	
escribir_sol	Mujer	Oscarcito le mostró el dibujo de su nave viajando alrededor del sol a Uma. La lora leyó “SOL”. Leé con la lora. Tocá donde dice sol. 	
escribir_sol1	Mujer	Después de escuchar el cuento, Oscarcito dibujó una nave viajando alrededor del sol. Ahora quiere escribir la palabra “SOL” . ¿Lo ayudás a Oscarcito a escribir? Arrastrá la letra que falta para completar la palabra.	
tocar_planeta	Mujer	Escuchá los nombres que dice la lora y tocá los que terminan como PLANETA.	
unir_animal_dibujo	Mujer	Uní la rima de cada animal con su dibujo	
letraR_1	Mujer	Rrrrrrr	
letraR_2	Mujer	¡ratón!	
letraML2_1	Mujer	Mmmmm	
letraML2_2	Mujer	¡Mano!	
letraS2L2_1	Mujer	Ssssssss	
letraS2L2_2	Mujer	¡Sapo!	
letraE_1	Mujer	Eeeeee	
letraE_2	Mujer	Elefante	
planetas_2	Mujer	Desde el Sol, el primer planeta es Mercurio. El segundo es Venus.	
planetas_3	Mujer	El tercero es la Tierra. Acá vivimos nosotros.	
planetas_4	Mujer	El cuarto es Marte. El quinto es Júpiter.	
planetas_5	Mujer	El sexto es Saturno. El séptimo es Urano, y el último, el octavo, es Neptuno.	
planetas_1	Mujer	¿Sabías que en nuestro sistema solar hay 8 planetas y que giran alrededor del sol? Escuchá cómo se llaman cada uno.	
toca_isla	Mujer	Oscarcito le mostró el dibujo de la isla a la lora Uma. La lora leyó isla. Leé con la lora. Tocá donde dice isla.	
toca_mapa	Mujer	La lora también leyó mapa. Leé con la lora. Tocá donde dice mapa.	
toca_pez	Mujer	Tocá donde dice mono.	
toca_mono	Mujer	Tocá donde dice isla.	
arrastrar_rio_pez	Mujer	¿Empiezan como río o como pez? Arrastrá los objetos al lado de río si empieza como Río y al lado de Pez, si empiezan como pez.	
aprender_barquito	Mujer	¿Querés aprender a hacer un barquito de papel? Mirá estas instrucciones	
barquitoPapel1_1	Mujer	Conseguí una hoja de papel.	
barquitoPapel2_2	Mujer	Doblá el papel por la mitad.	
barquitoPapel3_3	Mujer	Doblá los bordes de los costados hacia el centro.	
barquitoPapel4_4	Mujer	Doblá los bordes de abajo hacia arriba formando un sombrero.	
barquitoPapel5_5	Mujer	Tomalo de las puntas y empujá hacia adentro hasta juntar las dos puntas.	
barquitoPapel6_6	Mujer	Doblá la parte de abajo por delante y por detrás.	
barquitoPapel7_7	Mujer	Otra vez, tomá las dos puntas y empujalas hacia adentro hasta juntarlas.	
barquitoPapel8_8	Mujer	Tirá de las dos puntas de arriba hacia afuera.	
barquitoPapel9_9	Mujer	¡Y ya está! Ahí tenés un barquito. Podés ir a probarlo a un charquito.	
barquitoPapel10_10	Mujer	Jala los lados hacia fuera y ahi lo tenes, un barquito!	
aprenderBichos	Mujer	¿Querés aprender más sobre bichos?	
arrastrar_oso_abeja	Mujer	¿Empiezan como oso o como abeja? Arrastrá los objetos al lado de oso si empieza como Oso y al lado de Abeja, si empiezan como abeja.	
deci_toca_diferente	Mujer	Decí vos, como la lora Uma estas palabras. Tocá la que empieza diferente a las demás.	
toca_terminan_ave	Mujer	Escuchá atentamente.Tocá las palabras que terminan como Ave.	
distinto_tocalo	Mujer	Entre estos personajes hay uno que es distinto a los demás. Tocá el personaje que es distinto.	
rompecabezas_baile	Mujer	Los amigos del muchacho y otras personas del pueblo bailaron imitando al oso y al muchacho. Armá el rompecabezas para ver bailar a los vecinos del pueblo.	
toca_termina_ave	Mujer	Escuchá atentamente y tocá los que terminan como ave.	
toca_palabra_termina_a	Mujer	Tocá todo lo que termina como ala.	
arrastrar_elefante_azul	Mujer	¿Empiezan como elefante o como azul? Arrastrá los objetos al lado de elefante si empieza como Elefante y al lado de Azul, si empiezan como azul.	
toca_termina_e	Mujer	Tocá todo lo que termine como ave.	
frase_palabra-rio	Mujer	Tocá donde dice río.	
frase_palabra-rama	Mujer	Tocá donde dice rama.	
toca_uni_rima	Mujer	Tocá para escuchar las palabras y uní las que riman.	
mira_imagenes	Mujer	Mirá estas imágenes.	
leer_mar	Mujer	Ayudá a la lora Uma a leer el mensaje que Oscarcito le mandó al genio de la botella. Tocá donde dice MAR.	
toca_empieza_mar	Mujer	Nombrá estos dibujos como la lora Uma y tocá los que empiezan como MAR.	
descripcionPirata1_1	Mujer	Los piratas tienen un sombrero con un dibujo de una calavera	
descripcionPirata2_2	Mujer	Muchos piratas usaban barba y bigotes	
descripcionPirata3_3	Mujer	Muchos piratas se lastimaban un ojo y usaban un parche para cubrirlo.	
descripcionPirata4_4	Mujer	Muchos piratas, en las batallas, se lastimaban una pierna y usaban una pata de palo en su lugar.	
descripcionPirata5_5	Mujer	Muchos piratas, en las batallas, se lastimaban una mano y usaban un garfio en su lugar.	
descripcionPirata6_6	Mujer	Muchos piratas hacían mapas para recordar dónde escondían sus tesoros	
escribir_risa	Mujer	El ñandú corre y el pajarito vuela. Oscarcito dibujó al ñandú y al pajarito, y al lado escribió lo que hace cada uno. Ayudá a Oscarcito a escribir. La lora Uma dice la palabra y vos, completá la letra que falta.	
toca_dice	Mujer	Tocá donde dice...	
tip_repeat_with_cardL2	Mujer	¡Repetí cada palabra!	
presentacion_estaciones	Mujer	¿Sabés cuáles son las estaciones del año?	