/generic_texts/(.... wav)	character	text	
ayuda_familia_maestraL2	Mujer	Aprendemos español. Tu familia o tu maestra te ayuda.	Ayuda
rima_animales_dany	Mujer	El pollito Lito le dice al perrito: pío pío pío, tengo mucho frío	Rimas
rima_rulitos	Mujer	Un osito muy chiquitito es amigo del pollito.	
rima_rulitos_Nasheli_1	Nasheli	pollito	
rima_rulitos_2	Mujer	El gato es amigo del pato y el gallo es amigo del caballo	
rima_rulitos_Nasheli_2	Nasheli	pato	
rima_rulitos_Nasheli_3	Nasheli	caballo	
rima_integracion_1	Mujer	El gallo y el caballo corren atrás de un zapallo, mientras el gato y el pato comen del mismo plato	
rima_integracion_Nasheli_1	Nasheli	zapallo	
rima_integracion_Nasheli_2	Nasheli	plato	
rima_dany_amigos_1	Mujer	Mi perro Simón juega con el camión y mi perra Carlota juega con la pelota	
rima_dany_amigos_Nasheli_1	Nasheli	camión	
rima_dany_amigos_Nasheli_2	Nasheli	pelota	
rima_dany_amigos_2	Mujer	La vaca que juega en la hamaca tiene cola y se llama Lola	
rima_dany_amigos_Nasheli_4	Nasheli	cola	
rima_dany_amigos_Nasheli_5	Nasheli	Lola	
rima_liebre_tortuga_1	Mujer	Debajo de un botón que tiene Martín se encuentra un ratón que es muy chiquitín	
rima_liebre_tortuga_Nasheli_1	Nasheli	ratón	
rima_liebre_tortuga_Nasheli_2	Nasheli	chiquitín	
rima_liebre_tortuga_2	Mujer	Caracol col col / a la una sale el sol. / Luna, luna, luna, / el sol sale a la una	
rima_liebre_tortuga_Nasheli_3	Nasheli	sol	
rima_liebre_tortuga_Nasheli_4	Nasheli	luna	
rima_integracion_2	Mujer	El ratón Ramón juega con el avión y la oveja Rebeca juega con la muñeca	
rima_integracion_Nasheli_3	Nasheli	avion	
rima_integracion_Nasheli_4	Nasheli	muñeca	
rima_dany_familia_1	Mujer	Dice mamá Carolina que encierres a la gallina y que lleves al corral a cualquier otro animal	
rima_dany_familia_Nasheli_1	Mujer	gallina	
rima_dany_familia_Nasheli_2	Mujer	animal	
rima_dany_familia_2	Mujer	Dice el abuelo Mariano que se agarren de la mano. Dice la abuela Teresa que se toquen la cabeza	
rima_caperucita_roja_l2_1	Mujer	Mi abuela Manuela me lleva a la escuela y mi abuelo Carmelo me da un caramelo	
rima_caperucita_roja_l2_Nasheli_1	Nasheli	escuela	
rima_caperucita_roja_l2_Nasheli_2	Nasheli	caramelo	
rima_caperucita_roja_l2_2	Mujer	A mi hermana Ana le regalé una banana y a mi hermano Juan le regalé un pan	
rima_caperucita_roja_l2_Nasheli_3	Nasheli	banana	
rima_caperucita_roja_l2_Nasheli_4	Nasheli	pan	
rima_caperucita_roja_l2_3	Mujer	Cinco ratoncitos de colita gris, mueven las orejas, mueven la nariz. Uno, dos, tres, cuatro corren al rincón, porque viene el gato a comer ratón	
rima_caperucita_roja_l2_Nasheli_5	Nasheli	nariz	
rima_integracion3	Mujer	Cinco ratoncitos salen de la bota, mueven las manitos, tiran la pelota. Cinco ratoncitos bajan del camión, mueven los ojitos, corren al león	
gallinaContenta	Mujer	La gallina está contenta	Frases
gallinaEnojada	Mujer	La gallina está enojada	
enojado-oso	Mujer	¿Cómo está el oso chico?	
contento-nene	Mujer	¿Cómo está el nene?	
danyAsustado	Mujer	Dany está asustado	
danyContento	Mujer	Dany está contento	
hamaca-vaca	Mujer	¿Qué nombre termina como “vaca”?	
cola-lola	Mujer	¿Qué nombre termina como “Lola”?	
liebreContenta	Mujer	La liebre está contenta	
liebreSorprendida	Mujer	La liebre está sorprendida	
liebreCansada	Mujer	La liebre está cansada.	
avion-ramon	Mujer	¿Qué nombre termina como Ramon?	
muñeca-rebeca	Mujer	¿Qué nombre termina como Rebeca?	
gatoAdentroCaja	Mujer	El gato está adentro de la caja.	
perroArribaSilla	Mujer	El perro está arriba de la silla.	
gatoAbajoSilla	Mujer	El gato está abajo de la silla.	
perroAfueraCaja	Mujer	El perro está afuera dela caja. 	
corral-animal	Mujer	¿Qué nombre termina como animal?	
mano-mariano	Mujer	¿Qué nombre termina como “Mariano”?	
cabeza-teresa	Mujer	¿Qué nombre termina como “Teresa”?	
escuela-manuela	Mujer	¿Qué nombre termina como Manuela?	
caramelo-carmelo	Mujer	¿Qué nombre termina como Carmelo?	
banana-ana	Mujer	¿Qué nombre termina como “Ana”?	
raton-boton	Mujer	¿Qué palabra termina como botón?	
pan-juan	Mujer	¿Qué nombre termina como “Juan”?	
caperucitaContentaL2	Mujer	¿Cómo está Caperucita al principio del cuento?	
abuelaAsustadaL2	Mujer	¿Cómo está la abuela cuando encuentra al lobo?	
caperucitaContentaL2_2	Mujer	Caperucita está contenta	
caperucitaSorprendidaL2	Mujer	Caperucita está sorprendida	
caperucitaAsustadaL2	Mujer	Caperucita está asustada	
abuelaOrejas	Mujer	Abuela, que orejas tan grandes!	
abuelaNariz	Mujer	Abuela, que nariz tan grande!	
abuelaBoca	Mujer	Abuela, que boca tan grande!	
escucharteMejor	Mujer	Para escucharte mejor!	
olerteMejor	Mujer	Para olerte mejor!	
comerteMejor	Mujer	Para comerte mejor!	
nariz-gris	Mujer	¿Qué nombre termina como gris?	
raton-rincon	Mujer	¿Qué nombre termina como rincón?	
chivitoAfuera	Mujer	El chivito blanco va afuera del corral	
chivosAdentro	Mujer	Todos los chivos están adentro del corral	
chivitoEntra	Mujer	El chivito blanco entra al corral	
pelota-bota	Mujer	¿Qué nombre termina como “bota”?	
camion-avion	Mujer	¿Qué nombre termina como “avion”?	
sol-caracol	Mujer	¿Qué nombre termina como "caracol"?	
luna-numeroUno	Mujer	¿Qué nombre termina como "una"?	
lucasAlanAsustados	Mujer	Lucas y Alan se asustan	
lucasAlanContentos	Mujer	Lucas y Alan están contentos	
categoriaAnimales_1	Mujer	Mirá estos animales. ¿Cómo se llaman?	
categoriaAnimales2_2	Mujer	¿Cómo se llaman?	
categoriaColores_1	Mujer	Mirá estos colores. ¿Cómo se llaman?	Categorias
categoriaObjetosCasa_1	Hombre	Mirá los objetos que hay en las casas. ¿Cómo se llaman?	
categoriaObjetosCasa2_1	Hombre	Mirá los objetos que hay en las casas. ¿Cómo se llaman?	
objetosCasa4_1	Hombre	¿Qué objetos de la casa son? ¿Cómo son?	
objetosCasa2_1	Hombre	¿Qué objetos de la casa son? ¿Cómo son?	
categoriaPartesCuerpo_1	Mujer	Nuestro cuerpo. ¿Sabés cómo se llaman las partes del cuerpo?	
categoriaRopa_1	Hombre	Mirá esta ropa. ¿Conocés todos los nombres?	
ropa_1	Hombre	Mirá esta ropa. ¿Conocés todos los nombres?	
categoriaObjetosEstelares_1	Hombre	Mirá lo que hay en el cielo. ¿Conocés todos los nombres?	
categoriaAlimentos_1	Hombre	Mirá estos alimentos. ¿Te gustan? ¿Cómo se llaman?	
alimentos_1	Hombre	Mirá estos alimentos. ¿Cómo se llaman?	
alimentosCanasta_2	Hombre	Mirá estos alimentos. ¿Te gustan? ¿Cómo se llaman?	
categoria_familia	Mujer	Mirá la familia de Dany. ¿Quién es quién?  	
categoriaPartesCara_1	Hombre	La cara. ¿Sabés cómo se llaman las partes de la cara?	
categoriaJuguetes_1	Mujer	Mirá estos juguetes. ¿Cómo se llaman? 	
tip_escuchaL2	Nasheli	¡Escuchá muy bien!	Tips Consignas
tip_repeat_with_cardL2	Nasheli	¡Repetí cada palabra!	
tip_escucha_toca	Nasheli	Escuchá bien y tocá los dibujos que corresponden.	
tip_conta_cuentoL2	Dany	¿Te gustó el cuento? Ahora, contalo vos.	
tip_conversarL2	Dany	Conversá con tu familia o tu maestra.	
tip_questionsL2	Dany	A ver... ¿Qué te acordás del cuento?	
tip_informativo	Nasheli	¿Querés saber más? ¡Mirá!	
tip_falling_objectsL2	Nasheli	¡A buscar! Escuchá bien y tocá los dibujos que correspondan.	
tip_unirL2	Nasheli	¿Cuál va con cuál?	
tip_memotestL2	Nasheli	¿Tenés buena memoria? Encontrá los dibujos y los nombres que son iguales	
tip_memotest	Nasheli	¿Tenés buena memoria? Encontrá los dibujos y los nombres que son iguales	
tip_simonL2	Nasheli	¿Jugamos? Escuchá las palabras y tocá los dibujos en el mismo orden.	
tip_rompecabezasL2	Nasheli	¡Armá el rompecabezas!	
tip_read_automaticL2	Dany	¡Escuchá el cuento y luego conversá con tu familia, tu maestra o tu maestro!	
tip_paintL2	Dany	¡A pintar!	
tip_presentar_letraL2	Nasheli	Aprendemos las letras con Uma	
tip_toca_la_imagenL2	Mujer	¿Qué dibujo nombra Uma? Tocalo antes de que termine de nombrarlo.	
tip_labyrinthL2	Nasheli	¡Uy! ¡Un laberinto! ¿Qué camino hay que seguir?	
tip_completarL2	Dany	Completá la rima. ¡Nasheli y yo te ayudamos!	
tip_completar_soloL2	Dany	Ahora completá la rima vos.	
conversemos_sobreL2	Dany	Conversemos sobre...	
conversemos_sobre	Nasheli	Conversemos sobre...	
que_palabras_riman	Oscarcito	Escuchá bien. ¿Qué palabras terminan igual?	
unir_personajes_estados	Nasheli	¿Quién se siente así? Escuchá las palabras y uní cada una con el personaje que corresponda.	
tip_ordenar_cuentoL2	Dany	¡Uy! El cuento se desordenó. ¿Qué pasó primero? ¿Y después?... ¿Me ayudás a ordenar el cuento?	
ordenarMensaje	Dany	Tu maestra o tu familia te ayudan.	
toca_empiezan_igual	Mujer	Ahora vos, nombrá estos dibujos como la lora Uma y uní los que empiezan igual.	
tip_escucha_rimaL2	Dany	Escuchá la rima.	
tip_escucha_cancionL2	Dany	¿Cantamos?	
tip_repetir_loro	Nasheli	Hablamos como Uma. Repetí las palabras igual que la lora.	
tip_leer	Nasheli	Leamos juntos. Tocá la palabra que Uma lee.	
tip_letraL2	Nasheli	¡Uy! ¡A estas palabras les faltan letras! ¿Me ayudás a completarlas?	
tip_diferenciasL2	Dany	Mirá estas imágenes del cuento. ¿Cuáles son las diferencias?	
diferenciasCaperucita_1	Dany	Mirá estas imágenes del cuento. ¿Cuáles son las diferencias?	
rima_palabras_loro	Mujer	Ahora vos, nombrá uno de los dibujos como la lora Uma y tu familia o tu maestra tiene que descubrirlo.	
intro_animales	Mujer	Escuchá estos animales. ¿Los conocés? ¿Cómo se llaman?	
intro_animales_salvajes	Mujer	Escuchá estos animales. ¿Cómo se llaman?	
intro_animales_granja	Mujer	Escuchá estos animales. ¿Qué animales son? ¿Dónde están? ¿En una casa? ¿En el monte?	
escuchaCasaMonte	Mujer	Escuchá estos animales. ¿Qué animales son? ¿Dónde están? ¿En una casa? ¿En el monte?	
miraEstaImagen	Mujer	Mirá esta imagen.	
danyAnimales_1	Mujer	Mirá esta imagen. ¿Qué animales son?	Material de Actividades Cuento 1
danyAnimales_2	Mujer	¿Hay sólo animales en la imagen?	
danyAnimales1_1	Mujer	¿Qué animales tiene Dany?	
laminaDanyAnimales_1	Mujer	¿Qué animales tiene Dany?	
laminaDanyAnimales_4	Mujer	Él es Dany. Es un nene. 	
laminaDanyAnimales_5	Mujer	Tiene muchos animales: perro, gato, gallina, pollito, gallo, caballo, chancho, chivo, loro y burro.	
escuchar_repetir_animales	Mujer	Escuchá el nombre de los animales y repetilos.	
escuchar_repetir_colores	Mujer	Escuchá el nombre de los colores y repetilos.	
danyAnimales3_2	Mujer	¿Qué quería hacer Dany con el pollito?	
danyAnimales4_3	Mujer	Y entonces ¿qué pasó con la gallina?	
laberinto_dany_animales	Mujer	Ayudá al pollito a llegar a la gallina.	
animalesSalvajes_1	Mujer	Escuchá estos animales.	
animalesSalvajes_2	Mujer	¿Cómo se llaman?	
animalesSalvajes2_3	Mujer	Mirá estas imágenes. ¿Qué animales son? ¿Cómo son?	
animalesSalvajes_3	Mujer	Mirá estas imágenes. ¿Qué animales son? ¿Cómo son?	
animalesGranja_1	Mujer	Mirá estas imágenes. ¿Qué animales son?	
animalesGranja_2	Mujer	¿Cómo se llaman?	
danyAnimales3_4	Mujer	¿Qué pasó con la gallina de Dany?	
danyAnimales4_5	Mujer	¿Por qué la gallina se enoja con Dany?	
danyAnimales4_6	Mujer	¿Qué hace la gallina enojada?	
toca_animales_dany	Mujer	Tocá todos los animales que son de Dany	
elegi_colores	Mujer	Escuchá y tocá los colores	
colores_1	Nasheli	Mirá y nombrá estos colores.	
uni_gallinas_color	Mujer	Uní las gallinas con los pollitos del mismo color.	
danyAnimales2_7	Mujer	¿Qué pasó con la gallina de Dany?	
danyAnimales3_8	Mujer	¿Por qué se enoja la gallina?	
danyAnimales4_9	Mujer	Y entonces, ¿qué hace la gallina?	
danyAnimales4_10	Mujer	¿Y Dany?	
laminaDanyAnimales_6	Mujer	¿De qué colores son los animales de Dany?	
danyAnimales4_11	Mujer	Y al final, ¿qué pasó?	
tip_parte_cuentoL2	Dany	¿Qué parte del cuento es? Escuchá y tocá la imagen que corresponde.	
painting_animales_dany	Mujer	¿De qué colores son los animales de Dany? Pintá los animales.	
toca_animal_diferente	Mujer	Tocá el animal que es diferente a los demás. ¿Por qué es diferente?	
danyAnimales_7	Nasheli	Es de día. Hay sol. Dany está afuera de su casa.	
danyAnimales_8	Nasheli	Está sentado arriba del árbol junto a su gato negro.	
danyAnimales_9	Nasheli	Dany tiene muchos animales, tiene tres perros, un gallo, un caballo, un chancho, dos chivos, un loro, un burro y dos gallinas.	
danyAnimales_10	Nasheli	Una gallina es blanca y tiene cuatro pollitos. La otra gallina es amarilla.	
animalesMonte_1	Dany	¿Qué animales son?	Material de Actividades Cuento 2
animalesMonte_2	Dany	¿Dónde están? ¿En una casa? ¿En el monte?	
animalesMonte_3	Dany	¿Qué más escuchaste?	
escucha_repeti_cosas_casa	Hombre	Escuchá el nombre de los objetos que hay en la casa y repetilos.	
oso_4	Hombre	¿Conocés estos animales?	
oso_5	Hombre	Se llaman osos.	
oso_6	Hombre	¿Cómo son estos osos?	
oso_7	Hombre	¿Son chicos? ¿son grandes?	
rulitos1_1	Hombre	¿Dónde está Rulitos?	
rulitos2_2	Hombre	¿Qué encuentra en el monte?	
rulitos3_3	Hombre	Y entonces ¿qué pasó?	
oso_8	Dany	¿Cómo es el osito?	
oso_9	Nasheli	¿Cómo son sus dientes?	
rulitos2_4	Hombre	¿Qué encuentra Rulitos en el monte?	
rulitos2_5	Hombre	¿Quiénes viven en la casa?	
rulitos2_6	Hombre	¿Cómo son los osos?	
rulitos4_7	Hombre	¿Qué hay en la casa de los osos?	
rulitos4_8	Hombre	¿Cómo son los vasos, las sillas y las camas?	
rulitos4_9	Hombre	¿Por qué los vasos, las sillas, las camas son diferentes?	
rulitos8_10	Hombre	¿Qué vaso toma Rulitos?	
rulitos9_11	Hombre	¿En qué silla se sienta?	
rulitos10_12	Hombre	¿En qué cama duerme?	
rulitos5_13	Hombre	¿Por qué Rulitos elige el vaso chico, la silla chica y la cama chica?	
animalesChicosGrandes_1	Mujer	¿Qué animales son?	
animalesChicosGrandes_2	Mujer	¿Cómo son?	
rulitos6_14	Hombre	¿Qué pasa cuando los osos vuelven a la casa? ¿Qué ven?	
rulitos7_15	Hombre	¿A quién encuentran los osos en la cama? ¿Qué hacen? 	
rulitos2_16	Hombre	¿Qué encuentra Rulitos en el monte?	
rulitos4_17	Hombre	¿Qué tienen los osos en la casa del monte?	
rulitos4_18	Hombre	¿Cómo son las cosas? ¿Por qué?	
rulitos5_19	Hombre	¿Qué hace Rulitos en la casa? 	
rulitos5_20	Hombre	¿Por qué elige todas las cosas chicas?	
rulitos6_21	Hombre	¿Qué pasa cuando los osos vuelven a su casa?	
rulitos7_22	Hombre	¿Qué pasa al final?	
rulitos_23	Mujer	¿Te gustó el cuento?	
rulitos_24	Mujer	¿Qué parte te gustó más? ¿Por qué?	
rulitos5_25	Hombre	¿Qué hizo Rulitos en la casa de los Osos?	
rulitos6_26	Hombre	¿Por qué los Osos se enojan al llegar a su casa?	
rulitos6_27	Hombre	Y al final, ¿qué pasó?	
diferenciasRulitos_1	Hombre	¿Qué hace Rulitos? ¿Qué hacen los Osos? ¿Qué momentos del día aparecen?	
laberinto_rulitos	Hombre	Ayudá a Rulitos a llegar a la casa de los Osos.	
danyAnimales5_12	Mujer	¿Qué pasó con Dany y su gallina?	
danyAnimales4_12	Mujer	¿Qué pasó con Dany y su gallina?	Integracion 1
laminaDanyAnimales_13	Mujer	Dany tiene muchos animales. ¿Vos tenés animales?	
laminaDanyAnimales_14	Mujer	¿Qué animales tenés? ¿Cómo son?	
danyAnimales4_15	Mujer	¿Se enojan? ¿Por qué se enojan? ¿Qué hacen cuando se enojan?	
danyAnimales4_16	Mujer	¿A vos te asustan los animales? ¿Qué animales te asustan? ¿Por qué?	
toca_iguales	Mujer	¿Cuántos hay? ¡Tocá todos los iguales! ¿Por qué son iguales?	
objetosCasa2_1	Hombre	¿Qué objetos de la casa son? ¿Cómo son?	
objetosCasa_1	Hombre	¿Qué objetos de la casa son? ¿Cómo son?	
toca_animales	Nasheli	Tocá todos los animales. Nombrá todo lo que tocás.	
toca_objetos_casa	Mujer	Tocá todos los objetos de la casa. Nombrá todo lo que tocás.	
elegi_animal	Mujer	¿Qué animal es?	
mira_imagenes	Mujer	Mirá estas imágenes.	
danyAmigos_1	Mujer	Mirá estas imágenes. ¿Cómo se llaman estos juguetes? 	Dany y sus amigos
danyAmigos_2	Mujer	¿Está Dany? ¿Está solo?	
danyAmigos_3	Mujer	¿Qué hacen los nenes? ¿Y la nena?	
danyAmigos_4	Mujer	¿Qué juguetes tienen?	
danyAmigos_5	Mujer	¿Con quiénes está Dany?	
danyAmigos_6	Mujer	¿Qué tienen los amigos de Dany? ¿Qué hacen?	
escucha_repeti_juguetes	Mujer	Escuchá el nombre de los juguetes y repetilos.	
escucha_repeti_partes_cuerpo	Mujer	Escuchá los nombres de las partes del cuerpo y repetilos.	
toca_aviones	Mujer	¿Cuántos aviones hay? 	
toca_pelotas	Dany	¿Cuántas hay? Tocá todas las pelotas.	
presentacionLoroUrielL2	Mujer	Un amigo de Oscarcito tiene una lora que se llama Uma. Uma habla un poco raro. Escuchala.	
loroUriel_1	Mujer	Esta es la lora de Dany.	
loroUriel_2	Mujer	Se llama Uma.	
loroUriel_3	Mujer	La lora Uma habla un poco raro.	
loroUriel_5	Loro	Hoooola.	
loroUriel_6	Loro	Sssssssoy Uuuma.	
loroUriel_7	Loro	Uuuuma.	
danyAmigos_7	Mujer	Dany tiene muchos amigos: Sandra, Lucas, Alan, Juan y Nahuel.	
danyAmigos_8	Mujer	Dany y sus amigos tienen muchos juguetes: una pelota, un camión, una muñeca, cartas. 	
danyAmigos2_2	Mujer	¿A qué juegan Dany, Lucas y Alan?	
danyAmigos2_3	Mujer	¿Qué hace Lucas?	
danyAmigos6_4	Mujer	¿Qué pasa con la pelota?	
danyLucasAlan_1	Mujer	Mirá la imagen. ¿Qué pasa con Dany?	
danyLucasAlan_2	Mujer	¿Cómo están Lucas y Alan?	
danyLucasAlan_3	Mujer	¿Están contentos, asustados...? ¿Por qué?	
toca_autos	Mujer	Toca todos los autos.	
danyAmigos3_5	Mujer	¿Qué hace Dany?	
danyAmigos4_6	Mujer	¿Qué pasa con Dany?	
juguetes_1	Mujer	¿Qué juguetes son? ¿Cómo son?	
toca_juguetes	Mujer	Tocá todos los juguetes. Nombrá todo lo que tocás.	
danyAmigos5_7	Mujer	¿Qué hacen Lucas y Alan cuando Dany se cae? ¿Por qué?	
nenesActividades_1	Mujer	¿Qué hacen estos nenes y estas nenas?	
nenesJuegan_1	Mujer	¿Qué hacen estos nenes y estas nenas?	
nenesActividades_2	Mujer	¿Qué parte del cuerpo usan?	
cuerpo	Mujer	¿Cómo se llaman las partes del cuerpo?	
vacaLola_1	Dany	¿Qué partes del cuerpo nombra la canción?	
vacaLola_2	Nasheli	¿Qué dice la vaca Lola?	
elegi_parte_cuerpo	Mujer	¿Qué parte del cuerpo es?	
laberinto_dany_amigos	Mujer	Ayudá a Dany a llegar a la pelota.	
danyAmigos4_8	Mujer	¿Qué pasa con Dany cuando quiere bajar la pelota?	
danyAmigos5_9	Mujer	¿Qué hacen Lucas y Alan cuando Dany se cae? ¿Por qué?	
danyAmigos5_10	Mujer	¿Qué pasó al final? ¿Por qué Dany está contento?	
danyLucasAlanpt2_1	Mujer	¿Qué pasa con Dany?	
danyLucasAlanpt2_2	Mujer	¿Cómo están Lucas y Alan?	
danyLucasAlanpt2_3	Mujer	¿Están enojados, contentos...?	
intro_partes_cuerpo	Dany	Mirá las partes del cuerpo y decí sus nombres.	
amigos_1	Dany	Dany tiene muchos amigos. ¿Vos tenés amigos?	
amigos_2	Dany	¿Cómo se llaman?	
amigos_3	Dany	¿A qué juegan?	
amigos_4	Dany	¿Con qué juegan?	
amigos_5	Dany	¿Cuál es el juego que más te gusta? ¿Cómo es ese juego?	
amigos_6	Dany	¿Por qué te gusta?	
elegi_juguetes	Mujer	¿Qué juguete es?	
liebreTortuga_1	Hombre	¿Conocés estos animales?	La Liebre y la Tortuga
liebreTortuga_2	Hombre	¿Cuál camina más despacio ¿Cuál corre muy rápido?	
liebreTortuga1_1	Hombre	¿Qué quiere hacer la tortuga?	
liebreTortuga1_2	Hombre	¿Qué dice la liebre?	
liebreTortuga2_3	Hombre	Y entonces, ¿qué pasa?	
unir_partes_ropa	Hombre	Uní la parte del cuerpo con la ropa.	
liebreTortuga1_4	Hombre	¿A qué juegan la liebre y la tortuga?	
liebreTortuga2_5	Hombre	¿Quién corre más rápido, la liebre o la tortuga?	
liebreTortuga3_6	Hombre	¿Qué pasa en la carrera?	
unirRopa_1	Hombre	¿Qué ropa usa este nene? ¿Y la nena?	
toca_palabra_a	Mujer	Ahora vos, nombrá estos dibujos como Uma y tocá todo lo que empieza como azul.	
liebreTortuga1_7	Hombre	¿Qué hacen la liebre y la tortuga?	
liebreTortuga7_8	Hombre	¿Por qué la liebre está muy cansada?	
liebreTortuga5_9	Hombre	¿Qué hace la liebre? ¿y la tortuga?	
toca_pantalones	Hombre	¿Cuántos pantalones hay? 	
liebreTortuga6_10	Hombre	¿Por qué se duerme la liebre?	
liebreTortuga5_11	Hombre	¿Por qué la tortuga gana la carrera?	
diferenciasLiebreTortuga_2	Hombre	¿Qué quieren hacer la liebre y la tortuga? ¿Qué momento del día es?	
diferenciasLiebreTortuga_3	Hombre	¿Qué pasó al final con la liebre y la tortuga? ¿Qué momento del día es?	
laberinto_liebre_tortuga	Hombre	Ayudá a la tortuga a llegar a la meta.	
toca_estrellas	Hombre	¿Cuántas estrellas hay? 	
liebreTortuga4_12	Hombre	¿Qué pasa al final?	
escucha_repeti_cosas_cielo	Hombre	Escuchá el nombre de lo que hay en el cielo y repetilo.	
toca_nubes	Mujer	¿Cuántas nubes hay?	
toca_ropa	Hombre	Tocá toda la ropa. Nombrá todo lo que tocás.	
danyAmigos6_11	Mujer	¿Qué pasó con la pelota? 	Integracion 2
danyAmigos7_12	Mujer	¿Qué hicieron Dany y sus amigos?	
toca_m	Mujer	Ahora vos, nombrá estos dibujos como Uma y tocá todo lo que empieza como mano.	
animalesDiaNoche_1	Hombre	¿Qué animales son? ¿Cuándo se escuchan? ¿De día o de noche?	
cielos_1	Hombre	¿Qué momento del día es? ¿Cómo es el cielo?	
ropas_1	Hombre	El pantalón grande es azul y el chico es rojo.	
ropas_2	Hombre	La zapatilla chica es marrón y la grande es blanca.	
muñecaColores_1	Hombre	La muñeca tiene un brazo verde y el otro amarillo.	
muñecaColores_2	Hombre	La muñeca tiene una pierna roja y la otra azul.	
muñecaColores_3	Hombre	La muñeca tiene una mano naranja y la otra celeste.	
liebreTortuga3_13	Hombre	¿Quién ganó la carrera?, ¿por qué?, ¿qué pasó?	
danyFamilia_12	Mujer	Dany está con su familia. Su abuelo Juan, su abuela Eluisa, su mamá Beatriz y su papá Argelio	
danyFamilia_13	Mujer	La abuela de Dany calienta agua en la pava. La mamá pisa frutos con el mortero y el papá corta el pescado con el cuchillo. Dany y su abuelo están con los chivos. Muy cerca del abuelo está el perro de Dany.	
danyFamilia_1	Mujer	Esta es la familia de Dany: la mamá, el papá, la abuela y el abuelo.	Dany y su familia
danyFamilia_2	Mujer	¿Qué hacen? ¿Qué usan?	
danyFamilia_110	Mujer	¿Quiénes son Juan, Eluisa, Beatriz y Argelio?	
escucha_repeti_familia	Mujer	Escuchá quienes forman parte de la familia de Dany y repetilo.	
escucha_repeti_instrumentos_cocina	Mujer	Escuchá el nombre de los objetos de la casa y repetilos.	
osoOsito_1	Dany	¿Con quién está el osito?	
osoOsito_2	Nasheli	¿Qué le dice el papá al osito?	
danyFamilia2_3	Mujer	¿Quiénes están con Dany? ¿Recordás sus nombres?	
danyFamilia2_4	Mujer	¿Qué pasa con el chivito blanco? ¿Dónde está?	
danyFamilia2_5	Mujer	¿Hay más chivos? ¿Dónde?	
danyFamilia2_6	Hombre	¿Qué hacen Dany, su familia y su perro?	
danyFamilia_10	Mujer	¿Cómo es tu familia? ¿Qué haces con tu familia?	
diferenciasDanyFamilia_1	Mujer	¿Dónde está el chivito blanco: adentro o afuera del corral? ¿Y Dany?	
diferenciasDanyFamilia_2	Mujer	¿Y en la segunda imagen? ¿Dónde está el chivito blanco: adentro o afuera del corral? ¿Y Dany?	
corralAnimales_1	Mujer	¿Dónde están estos animales: adentro o afuera del corral?	
perritoLugares_1	Mujer	¿Dónde está el perrito?	
gatitoLugares_1	Mujer	¿Dónde está el gatito?	
danyFamilia2_6	Mujer	¿Qué hacen Dany, su familia y su perro?	
danyFamilia3_4	Mujer	¿Qué pasa con el chivito?	
laberinto_dany_familia_1	Mujer	Ayudá al chivito a llegar al corral.	
danyFamilia4_5	Mujer	¿Qué hace Dany cuando el chivito entra al corral?, ¿por qué?	
danyFamilia4_6	Mujer	Y al final, ¿dónde están todos los chivos?	
danyFamilia1_7	Mujer	¿Qué pasa con los chivos grandes?, ¿y con el chivo chiquito y blanco?	
danyFamilia_8	Mujer	¿Quiénes son? ¿Qué objetos tienen?	
danyAbuelo_9	Mujer	¿Qué están haciendo?	
toca_cucharas	Mujer	¿Cuántas cucharas hay? 	
danyFamilia2_7	Mujer	¿Por qué todos corren al chivito blanco?	
danyFamilia2_8	Mujer	¿Por qué Dany y su familia quieren llevar todos los chivos al corral?	
familia_1	Mujer	¿Cómo es tu familia? ¿qué hacés con tu familia?	
familia_2	Mujer	¿Qué es lo más te gusta hacer? ¿con quién? ¿por qué?	
caperucitaRoja_1	Hombre	¿Conocés a esta nena? Se llama Caperucita Roja	Caperucita Roja
caperucitaRoja_2	Hombre	¿Cómo está vestida? ¿De qué color?	
caperucitaRoja_3	Hombre	¿Qué tiene en la mano? ¿Está sola en el monte?	
escucha_repeti_partes_cara	Hombre	Escuchá el nombre de las partes de la cara y repetilos.	
caperucitaRoja1_1	Hombre	¿Qué le da la mamá a Caperucita? ¿Para quién es la comida?	
caperucitaRoja2_2	Hombre	¿Quién está escondido en el monte? ¿Qué huele el Lobo?	
caperucitaRoja2_3	Hombre	¿Adónde va Caperucita? ¿Qué lleva?	
caperucitaRoja3_4	Hombre	¿A quién encuentra en el monte?	
caperucitaRoja33_5	Hombre	¿Por qué el Lobo se acerca a hablar con Caperucita?	
caperucitaRoja33_6	Hombre	¿Qué quiere saber el Lobo?	
toca_palabra_s	Mujer	Ahora vos, nombrá estos dibujos como Uma y tocá todo lo que empieza como sol.	
caperucitaRojapt2_1	Hombre	Para ir a la casa de la abuela de Caperucita Roja hay dos caminos.	
caperucitaRojapt2_2	Hombre	¿Cómo son? ¿Qué camino toma el Lobo? ¿Y Caperucita?	
caperucitaRojapt2_3	Hombre	¿Por qué Caperucita toma el camino largo?	
caperucitaRojapt2_4	Hombre	¿Quién llega primero a la casa de la abuela? ¿Por qué?	
caperucitaRojapt2_7	Hombre	¿Cuántos caminos hay para ir a la casa de la abuela? ¿cómo son?	
caperucitaRojapt2_8	Hombre	¿El Lobo y Caperucita van por el mismo camino?	
caperucitaRojapt2_9	Hombre	¿Por qué toman distintos caminos?	
caperucitaRoja3_10	Hombre	¿Qué dice el Lobo a Caperucita?	
laberinto_caperucita_l2	Mujer	Ayudá a Caperucita a llegar a la casa de su abuela	
caperucitaRojapt3_1	Hombre	¿Es la abuela o es el Lobo?	
caperucitaRojapt3_2	Hombre	¿Qué ropa tiene el Lobo?	
caperucitaRojapt3_3	Hombre	¿Por qué el Lobo se viste como la abuela?	
alimentos_2	Mujer	¿Qué alimento es? ¿Cómo es?	
toca_manzanas	Hombre	¿Cuántas manzanas hay? 	
caperucitaRoja5_11	Hombre	¿Qué pasa con la abuela cuando el Lobo llega a su casa?	
caperucitaRoja56_12	Hombre	¿Qué hace la abuela?, ¿y el Lobo?	
caperucitaRoja56_13	Hombre	¿De quién es el vestido y el pañuelo que se pone el Lobo?	
caperucitaRoja6_14	Hombre	¿Por qué el Lobo se viste de Abuela?	
toca_palabra_l	Mujer	Ahora vos, nombrá estos dibujos como Uma y tocá todo lo que empieza como loro.	
caperucitaRoja6_15	Hombre	Cuándo Caperucita llega a la casa de la abuela, ¿a quién encuentra?	
caperucitaRoja7_16	Hombre	Y entonces ¿qué pasa? ¿Quién llega a la casa de la abuela?	
caperucitaRoja8_17	Hombre	¿Qué hace el papá? ¿y el Lobo?	
caperucitaRoja8_18	Hombre	¿Cómo están la abuela y Caperucita al final?	
cincoRatoncitos_1	Dany	¿Cuántos ratoncitos hay?	
cincoRatoncitos_2	Nasheli	¿Qué partes de la cara mueven?	
cincoRatoncitos_3	Nasheli	¿Por qué los ratoncitos corren al rincón?	
toca_alimentos	Hombre	Tocá todos los alimentos. Nombrá todo lo que tocás.	
unir_sentidos	Hombre	¿Qué parte de la cara usamos? Uní la parte la parte de la cara con el dibujo que corresponde.	
danyFamilia3_9	Mujer	¿Qué pasó con el chivo de Dany? ¿Qué hicieron Dany y su familia?	Integración 3
unir_familia_elementos	Mujer	La abuela, la mamá y el papá de Dany preparan la comida. ¿Qué objetos usan para cocinar? Uní la persona con el objeto que corresponda.	
alimentosColores_1	Nasheli	La banana es amarilla.	
alimentosColores_2	Nasheli	La manzana es roja.	
alimentosColores_3	Nasheli	La leche es blanca.	
caperucitaRoja3_19	Hombre	¿Qué le pasó a Caperucita cuando fue a visitar a su abuela?	
caperucitaRoja5_20	Hombre	¿Qué le pasó a la abuela?	
caperucitaRoja7_21	Hombre	Y al final, ¿cómo terminó la historia?	
elegi_lobo_ropa	Nasheli	El Lobo se viste como la abuela de Caperucita. Escuchá qué ropa usa y tocá la imagen que corresponde.	
animales_introL2	Dany	Hablemos sobre animales	
liebreEstados_1	Mujer	¿Cómo está la liebre? ¿Está contenta, sorprendida, cansada? ¿Por qué? 	
letraAL2_1	Mujer	Aaaaa	
letraAL2_2	Mujer	¡Araña!	
letraOL2_1	Mujer	Oooo	
letraOL2_2	Mujer	¡Oso!	
cancion_animales_integracion	Mujer	A	
letraML2_1	Mujer	Mmmmm	
letraML2_2	Mujer	¡Mano!	
toca_objeto_diferente	Mujer	Toca el que es diferente a los demas. ¿Por qué es diferente?	
letraE_1	Mujer	Eeeeeeeeee	
letraE_2	Mujer	¡Elefante!	
letraS2_1	Mujer	Ssssssss	
letraS2_2	Mujer	¡Sapo!	
completa_cancion	Mujer	Completá la canción!	
toca_osos	Mujer	Tocá todos los osos.	
toca_abeja	Mujer	Tocá la abeja chica.	
toca_caballo	Mujer	Tocá el caballo mediano.	
toca_pato	Mujer	Tocá el pato grande.	
toca_gallo	Mujer	Tocá el gallo chico.	
toca_gato	Mujer	Tocá el gato mediano.	
toca_oveja	Mujer	Tocá la oveja grande.	
toca_cama	Mujer	Tocá la cama chica.	
toca_silla	Mujer	Tocá la silla mediana.	
toca_vaso	Mujer	Tocá el vaso grande.	
osoEstados_1	Mujer	¿Cómo está el oso chico... enojado, contento o sorprendido? ¿Por qué?	
toca_perro_naranja	Mujer	Tocá el perro mediano naranja.	
toca_loro_rojo	Mujer	Tocá el loro chico rojo.	
toca_gallina_azul	Mujer	Tocá la gallina grande azul.	
toca_mono_amarillo	Mujer	Tocá el mono chico amarillo.	
frase_pelota3	Mujer	Que rima con carlota?	
frase_camion	Mujer	que rima con simon?	
toca_muñeca	Mujer	Tocá la muñeca grande rosa.	
toca_auto_amarillo	Mujer	Tocá el auto grande amarillo.	
toca_pelota_azul	Mujer	Tocá la pelota chica azul.	
toca_avion_rojo	Mujer	Tocá el avión grande rojo.	
toca_sol_amarillo	Mujer	Tocá el sol grande y amarillo.	
toca_luna_verde	Mujer	Tocá la luna grande y verde.	
toca_sol_azul	Mujer	Tocá el sol chico y azul.	
toca_luna_roja	Mujer	Tocá la luna chica y roja.	
toca_pantalon_amarillo	Mujer	Tocá el pantalón amarillo.	
toca_remera_rojo	Mujer	Tocá la remera roja.	
toca_ojotas_verdes	Mujer	Tocá las ojotas medianas verdes.	
toca_media_amarilla	Mujer	Tocá las medias grandes amarillas.	
toca_jarras	Mujer	¿Cuántas jarras hay?	
toca_cuchillo_amarillo	Mujer	Tocá el cuchillo grande y amarillo.	
toca_tenedor_naranja	Mujer	Tocá el tenedor chico y naranja.	
toca_olla_azul	Mujer	Tocá la olla mediana y azul.	
alimentosCanasta_1	Mujer	¿Qué alimentos son? ¿Dónde están?	
danyPresentaAmigos	Mujer	Dany te presenta a sus amigos.	
tip_contar	Mujer	Contá cuantos objetos iguales hay y tocá el numero que corresponda.	
cual_esDiferente	Dany	¿Cuál es el diferente? ¿Por qué es diferente?	
osito_8	Dany	¿Cómo es el osito?	
osito_9	Nasheli	¿Cómo son sus dientes?	
abejaSizes1_1	Mujer	Abeja chica	
abejaSizes2_2	Mujer	Abeja mediana	
abejaSizes3_3	Mujer	Abeja grande	
caballoSizes1_1	Mujer	Caballo chico	
caballoSizes2_2	Mujer	Caballo mediano	
caballoSizes3_3	Mujer	Caballo grande	
patoSizes1_1	Mujer	Pato chico	
patoSizes2_2	Mujer	Pato mediano	
patoSizes3_3	Mujer	Pato grande	
camaSizes1_1	Mujer	Cama chica	
camaSizes2_2	Mujer	Cama mediana	
camaSizes3_3	Mujer	Cama grande	
sillaSizes1_1	Mujer	Silla chica	
sillaSizes2_2	Mujer	Silla mediana	
sillaSizes3_3	Mujer	Silla grande	
vasoSizes1_1	Mujer	Vaso chico	
vasoSizes2_2	Mujer	Vaso mediano	
vasoSizes3_3	Mujer	Vaso grande	
categoriaAnimales2_1	Mujer	Mirá estos animales.	
danyAnimales2_4	Mujer	¿Qué pasó con la gallina de Dany?	
danyAnimales3_5	Mujer	¿Por qué la gallina se enoja con Dany?	
cuantas_pelotas_hay	Dany	¿Cuántas pelotas hay?	
letraL_1	Mujer	L...	
letraL_2	Mujer	Luna	
toca_o	Mujer	Ahora vos, nombrá estos objetos como Uma y tocá todo lo que empieza como oso.	
loroUriel_1	Mujer	Esta es la lora de Dany.	
loroUriel_2	Mujer	Se llama Uma.	
loroUriel_3	Mujer	La lora Uma habla un poco raro.	
loroUriel_4	Mujer	Escuchá cómo dice su nombre y repetilo como ella lo dice.	
	Mujer	Ahora vos, nombrá estos dibujos como Uma y tocá todo lo que empieza como mano	